痰貯留多	喀痰	膿性痰
皮膚リンパ腫	菌状息肉症	皮膚Ｔ細胞リンパ腫
個細胞壊死	壊死	末梢壊死
左大腿骨顆上骨折	大腿骨外顆骨折	大腿骨顆上骨折
病原性大腸菌Ｏ−１５７感染性腸炎	病原性大腸菌感染症	大腸菌性腸炎
口腔粘膜浮腫	浮腫	角膜浮腫
閉塞性膵炎	膵炎	亜急性膵炎
間質性肺水腫	肺水腫	急性肺水腫
舌扁平上皮癌	舌癌	膀胱扁平上皮癌
両側肺門部浸潤影	胸部異常陰影	肺門部異常陰影
抗癌剤漏出	薬剤漏出性皮膚障害	抗癌剤漏出性皮膚障害
水痘帯状疱疹	帯状疱疹	口腔帯状疱疹
ｓｙｓｔｅｍｉｃ　ｍａｓｔｏｃｙｔｏｓｉｓ	肥満細胞腫症	ＣＡＤＡＳＩＬ
発汗多量	多汗症	発汗障害
ＳＩＡＤ	抗利尿ホルモン不適合分泌症候群	ＡＩＤＳ
左後頭葉梗塞	脳梗塞	皮質枝梗塞
大腸菌菌血症	菌血症	腸管出血性大腸菌感染症
右前頭葉出血	脳出血	新生児頭蓋内出血
仙椎陳旧性骨折	陳旧性骨折	仙骨骨折
心室中隔穿孔	心室中隔欠損症	心室中隔瘤
ぼんやり感持続	反応性低下	倦怠感
右鼠径部痛	鼡径部痛	僧帽筋痛
皮疹不変	発疹	汗疹湿疹化
腸閉塞歴	イレウス	直腸閉鎖
紅斑局面多発	紅斑症	多形紅斑
下部進行食道癌	食道癌	下部食道癌
無γグロブリン血症	無ガンマグロブリン血症	低グロブリン血症
手首疼痛	疼痛	手部痛
ｓｐｌｅｎｉｃ　ｍａｒｇｉｎａｌ　ｚｏｎｅ　ｌｙｍｐｈｏｍａ	脾辺縁帯リンパ腫	ＭＮＧＩＥ
体動時息ぎれ	労作時呼吸困難	息切れ
ふらつき注意	よろめき歩行	よろめき感
新出肝転移	転移性肝癌	転移性肝腫瘍
脊椎カリエス	脊椎結核	陳旧性腰椎カリエス
行動障害	素行障害	行動緩慢
小豆大紅斑	紅斑症	新生児紅斑
腹腔鏡補助下子宮筋腫核	子宮筋腫	有茎性漿膜下子宮筋腫
神経根障害	神経根炎	副神経障害
後鼻汁症候群	後鼻漏	鼻汁
糖尿病性腎症１期	腎性糖尿	１型糖尿病性腎症第５期
左前頭葉心原性脳梗塞	心原性脳塞栓症	心原性小脳梗塞
閉塞性尿路感染	尿路感染症	急性尿路感染
顔面蝶形紅斑	ＬＥ蝶形皮疹	多形紅斑
上行結腸癌肝転移	転移性肝癌	肝癌骨転移
仙骨部色素沈着	色素異常症	歯の色素沈着
肥満糖尿病	糖尿病	前糖尿病
左肩痛み	肩部筋痛	肩部痛
ＰＳＶＴ発作	発作性上室頻拍	ＰＣＷＨ
ＤＭＮ　２期	糖尿病	ＨＤＬＳ
労作時胸部絞扼感	胸内苦悶	咽頭絞扼感
右膝変形	変形性膝関節症	足部変形
骨性腫瘤	腫瘤	骨腫瘤
家族性海綿状血管腫	海綿状血管腫	多発性海綿状血管腫
下肢動脈瘤	下肢の動脈瘤	上肢動脈瘤
精神病様症状	精神病	症状精神病
項頸部痛	頚部痛	項部痛
左大腿骨転子部粉砕骨折	転子下骨折	大腿骨転子部骨折
最近眠気	非器質性過眠症	慢性眠剤中毒
ＶＨＤ	心臓弁膜症	ＨＤＬＳ
夜頻尿	夜間頻尿症	乏尿
回盲部炎	回盲部憩室炎	中耳炎
重症肺血栓塞栓症	肺塞栓症	慢性肺血栓塞栓症
右乳突蜂巣	乳様突起炎	乳房のう胞
右肺尖部気胸	気胸	肺胞性肺気腫
骨盤内子宮内膜症	子宮内膜症	骨盤子宮内膜症
局麻薬アレルギー	薬物過敏症	抗アレルギー薬中毒
慢性蕁麻疹	慢性じんま疹	麻疹
高分化型漿液性腺癌	癌	卵巣漿液性腺癌
外側疼痛	疼痛	急性疼痛
卵巣癌再発卵巣癌	卵巣癌	再発卵巣癌
錐体路病変	錐体外路系疾患	錐体路障害
リンパ球性白血病	リンパ性白血病	前リンパ球性白血病
奬液性嚢胞腺腫	膵漿液性のう胞腺腫	卵巣漿液性腺腫
脳血栓塞栓症	脳血管閉塞性脳梗塞	脳血栓症
左リウマチ性肘関節症	関節リウマチ・膝関節	関節リウマチ・肘関節
右下腿潰瘍感染	下腿皮膚潰瘍	下腿難治性皮膚潰瘍
気分不快時	悪心	気分変調症
脂肪性腫瘤	脂肪腫	皮下腫瘤
ウィルス性肺炎	肺炎	ウイルス性肺炎
類円形紅斑	紅斑症	多形紅斑
書字不能	書痙	書字障害
熱型	発熱	熱射病
骨盤内充実性腫瘍	骨盤腫瘍	骨盤骨良性腫瘍
両側角乾燥性結膜炎	結膜炎	乾性角結膜炎
直腸肛門奇形	鎖肛	人工肛門部腸管脱出・術後早期
右大腿部腫瘍	大腿悪性軟部腫瘍	大腿軟部腫瘍
上大静脈血栓	静脈血栓症	下大静脈血栓症
ＰＫＤ	多発性のう胞腎	ＰＣＷＨ
分水嶺脳梗塞	脳梗塞	分水界梗塞
上皮性腫瘍	腫瘤	頭皮良性腫瘍
大球性正色素貧血	大球性貧血	正球性正色素性貧血
挙上空腸穿孔	腸穿孔	挙上空腸狭窄
肛門周囲びらん	外痔びらん	肛門部びらん
胸部不快	胸内苦悶	胸部不快感
下葉肺炎	肺炎	大葉性肺炎
右足根部粉砕骨折	粉砕骨折	上腕骨粉砕骨折
出血多量	急性大量出血	多量出血
腹水多量	腹水症	異常腹水
腸間膜リンパ管腫	リンパ管腫	腸間膜リンパ節腫脹
右乳腺線維腫症	線維腫	乳腺線維腫
肺野鬱血像	肺野異常陰影	肺胞出血
陰嚢びらん	陰のうびらん	陰茎びらん
精神的ショック	ショック	情緒性ショック
右上腕骨外側上顆炎	外側上顆炎	内側上顆炎
難治性非定型性抗酸菌症	非結核性抗酸菌症	ＨＩＶ非結核性抗酸菌症
軽度腹水	腹水症	異常腹水
大後頭孔狭窄	軟骨形成不全症	後鼻孔狭窄
熱型変化	発熱	熱射病
月経痛コントロール不十分	月経痛	月経不順
右ＤＶＴ	深部静脈血栓症	ＡＶＭ
非特異的胸痛	胸痛	反復性胸痛
Ａｅｒｏｍｏｎａｓ　ｈｙｄｒｏｐｈｉｌａ敗血症	敗血症	ＭＲＳＡ敗血症
重症細菌性敗血症	敗血症	連鎖球菌性敗血症
腹直筋膜下血腫	筋肉内血腫	腹壁下血腫
関連腎臓病	腎疾患	慢性腎臓病
非ケトン性高血糖	高血糖高浸透圧症候群	ケトン性低血糖症
声帯浮腫	声帯炎	声門浮腫
咳嗽持続	咳	慢性咳嗽
左側下顎骨嚢胞	顎骨のう胞	上皮性顎骨のう胞
シャント吻合部狭窄	透析シャント狭窄	吻合部狭窄
無気力	無力症	気逆
胸骨炎	胸骨周囲炎	胸骨骨髄炎
上肢疼痛	疼痛	上肢痛
左心不全徴候	心不全	左心不全
朝方疼痛	疼痛	難治性疼痛
蜂窩肺形成	蜂窩織炎	肺形成不全症
右ＩＣＡ高度狭窄	内頚動脈狭窄症	後大脳動脈狭窄
非ヘルペス性辺縁系脳炎	辺縁系脳炎	自己免疫性辺縁系脳炎
無症候性ＶＴ	心室頻拍	換気量減少
口腔清掃	個人衛生の著しいレベル低下	口腔内装置不適合
無石性胆嚢炎	胆のう炎	胆石性胆のう炎
両顎下腺腫大	顎下腺肥大	顎下腺多形腺腫
夜間中途覚醒時	睡眠障害	非器質性睡眠・覚醒スケジュール障害
薬剤性骨髄抑制	骨髄機能低下	薬剤性骨軟化症
旅行者下痢症	下痢症	感染性下痢症
非Ｂ非Ｃ型肝硬変	肝硬変症	Ｂ型肝硬変
足がむくみ	下肢浮腫	扁平足
左下顎骨慢性骨髄炎	慢性顎骨骨髄炎	下顎骨骨髄炎
右後角脳室内出血	脳室内出血	新生児脳室内出血
難治性浮腫	高度浮腫	浮腫
Ｇｒａｎｕｌｏｍａｔｏｓｉｓ　ｗｉｔｈ　ｐｏｌｙａｎｇｉｉｔｉｓ	多発血管炎性肉芽腫症	ＣＡＤＡＳＩＬ
Ｃ型肝硬変症	Ｃ型肝硬変	肝硬変症
未分化癌	癌	肺未分化癌
両側副腎悪性リンパ腫	悪性リンパ腫	先天性リポイド副腎過形成症
左膝痛み	膝関節痛	膝窩部痛
炎症性貧血	貧血	症候性貧血
両下肢掻痒感	皮膚そう痒症	片側痛覚過敏
ｍａｓｓ　ｌｅｓｉｏｎ	腫瘤	ＣＡＤＡＳＩＬ
右大脳半球多発脳梗塞	多発性脳梗塞	無症候性多発性脳梗塞
鎮静困難	興奮状態	動揺病
再発腫瘤近傍	腫瘤	多発性皮下腫瘤
腹腔内膿瘍形成	膿瘍	腹腔内膿瘍
腎被膜下出血	外傷性腎被膜下血腫	腎周囲出血
非Ｃｌｏｓｔｒｉｄｉｕｍ性ガス壊疽	ガス壊疽	ＬＳＤ中毒
リンパ腺腫脹	リンパ節腫大	耳後部リンパ節腫脹
多房性膿瘍	膿瘍	水晶体膿瘍
右耳介後部痛	耳痛症	耳下部痛
無呼吸症候群	無呼吸発作	中東呼吸器症候群
甲状腺嚢腫	甲状腺のう胞	甲状腺腫
両側浸出性中耳炎	滲出性中耳炎	出血性中耳炎
覚醒度	麻酔覚醒遅延	触覚鈍麻
有意弁膜症	弁膜炎	連合弁膜症
右下肺野無気肺	無気肺	下葉無気肺
小脳性失調	小脳性運動失調症	急性小脳性失調症
主幹動脈狭窄	脳動脈狭窄症	動脈狭窄
創部皮下血腫	外傷性皮下血腫	頭部皮下血腫
両肺小結節影	肺野異常陰影	肺野円形陰影
造影剤アレルギー歴	薬物過敏症	抗アレルギー薬中毒
慢性的な抑うつ気分	うつ状態	混合性不安抑うつ障害
鼻部異物肉芽腫	皮膚異物肉芽腫	異物肉芽腫
子宮がん	子宮癌	子宮前傾
睾丸腫脹	精巣腫脹	鼡径部腫脹
脳実質外腫瘍	腫瘍	脳幹部腫瘍
抑鬱感	気うつ	倦怠感
扁桃腺腫大	扁桃肥大	下垂体巨大腺腫
噴門部狭窄	胃狭窄	噴門狭窄
突発性腎出血	腎出血	特発性腎出血
傍大動脈ＬＮ	大動脈周囲リンパ節転移	ループス腎炎
左椎骨動脈低形成	骨髄低形成	椎骨動脈狭窄症
左房拡張	心拡大	頭囲拡大
サルモネラ菌感染症	サルモネラ感染症	プロテウス菌感染症
右足背発赤	発赤	下腿発赤
皮膚硬化がまだかなり	新生児皮膚硬化症	先天性皮膚欠損
蠕動不良	異常腸音	動悸
黒色丘疹	丘疹	黒色丘疹性皮膚症
クモ膜下嚢胞	くも膜のう胞	口腔類表皮のう胞
Ｈａｅｍｏｐｈｉｌｕｓ　ｉｎｆｌｕｅｎｚａｅ敗血症	敗血症	インフルエンザ菌敗血症
右上葉原発肺小細胞癌	小細胞肺癌	上葉非小細胞肺癌
急性小脳失調症	急性小脳性失調症	急性中毒性小脳失調症
浸潤癌化所見	癌	肺未分化癌
痔核脱出	痔核	脱出性内痔核
重症膵炎	膵炎	重症急性膵炎
痛みアリ	疼痛	項部痛
右足疼痛	疼痛	足痛
増殖前網膜症	網膜症	増殖性網膜症
小腸膀胱瘻	膀胱皮膚瘻	直腸膀胱瘻
結核性嚢腫	結核	結核腫
大腿腫脹	下腿腫脹	大腿部腫脹
全身性ＣＭＶ感染症	サイトメガロウイルス感染症	先天性サイトメガロウイルス感染症
両下肢圧痕性浮腫	クインケ浮腫	下肢浮腫
下部腸間膜動脈出血	動脈性出血	下部消化管出血
ＩｇＭ型Ｍ蛋白	単クローン性免疫グロブリン血症	免疫グロブリンＨ鎖欠損症
喘息発作様症状	気管支喘息発作	外因性喘息
腹水大量	腹水症	異常腹水
全身皮膚発赤	発赤	下腿発赤
多発肺嚢胞	肺のう胞	先天性のう胞肺
口腔内びらん	口唇びらん	鼻腔内びらん
紅斑熱群リケッチア症	リケッチア感染症	伝染性紅斑
肺外小細胞癌	小細胞肺癌	肺門部小細胞癌
ｂｒｅａｋｔｈｒｏｕｇｈ　ｈｅｐａｔｉｔｉｓ	肝炎	Ｅｕｔｈｙｒｏｉｄ　Ｓｉｃｋ症候群
左室圧排	右室肥大	頭蓋内圧亢進症
飲みこみにくさ	嚥下障害	多飲症
副腎ヒストプラズマ感染症	真菌症	ＨＣウイルス腎症
両松葉杖歩行	歩行障害	歩行異常
冠動脈狭窄３枝病変	狭心症３枝病変	先天性冠状動脈異常
遺伝性低尿酸血症	低尿酸血症	続発性高尿酸血症
小腸皮膚瘻	皮膚瘻	直腸皮膚瘻
非細菌性血栓性疣贅	疣贅	感染性疣贅
特発性腸間膜血腫	血腫	消化管血腫
肝骨転移	骨転移癌	肝癌骨転移
乳腺線維腫症	線維腫	乳腺線維腫
術後左反回神経麻痺	反回神経麻痺	術後性反回神経麻痺
無症候性髄膜腫	髄膜腫	悪性髄膜腫
表皮内水疱形成	先天性表皮水疱症	接合部型先天性表皮水疱症
後頚部圧痛	圧痛	頚部痛
良性胆道狭窄	胆管狭窄症	先天性胆管狭窄症
ＣＫＤ　腎硬化症	腎硬化症	良性腎硬化症
前頭葉出血	出血	後出血
有茎性乳頭状腫瘍	腫瘍	充実性偽乳頭状腫瘍
理解困難	言語理解障害	特殊学習困難
スメア異常	腟スメア細胞診陽性	エナメル質異常
腹腔内敗血症	敗血症	ＧＢＳ敗血症
過呼吸状態	過換気症	周期性呼吸
右肺門部原発肺小細胞癌	小細胞肺癌	肺門部小細胞癌
胃癌骨髄癌腫症	骨髄転移	髄膜癌腫症
眼乾燥感	ドライアイ	眼性眼振
内側縦束症候群	核間性眼筋麻痺	延髄外側症候群
左上下肢軽度麻痺	四肢麻痺	下肢麻痺
下肢痙性	痙性対麻痺	下肢痙攣
皮疹状況	発疹	丘疹状湿疹
髄外形質細胞腫	骨外性形質細胞腫	形質細胞腫
重症ＡＧＨＤ	重症成人成長ホルモン分泌不全	ＨＤＬＳ
湿疹性病変	湿疹	急性湿疹
手内筋萎縮	筋萎縮症	下肢筋萎縮
高度視力障害	視力障害	急性視力障害
昨夜微熱	微熱	慢性微熱
腓腹筋痙攣	痙攣	腓腹筋痛
破壊性脊椎症	脊椎症	外傷性脊椎症
胆嚢破裂	胆のう管破裂	胆管萎縮
独歩不可	歩行障害	歩行困難
骨破壊進行	関節リウマチ	骨壊死
下肢白癬	白癬	四肢白癬
左鼓膜発赤	発赤	青色鼓膜
熱苦症状	発熱	熱中症
肺動脈弁閉鎖症	肺動脈弁閉鎖	純型肺動脈弁閉鎖症
脾摘施行Ｃ型肝炎	Ｃ型肝炎	肝内胆細管炎
胸水セルブロック	胸水貯留	胎児胸水
右肺上葉すりガラス影	胸部異常陰影	肺野円形陰影
腫瘍性ＤＩＣ	線溶亢進	新生児播種性血管内凝固
左肘関節亜脱臼	亜脱臼	肘関節脱臼
左肺感染性嚢胞	肺のう胞	侵襲性肺炎球菌感染症
右足趾壊疽	下肢壊疽	足壊疽
残遺癌	癌	胎児性癌
ＭＳ再発	多発性硬化症	僧帽弁狭窄症
強直間代性痙攣発作	間代性痙攣	間代強直性痙攣
一過性意識消失発作	一過性脳虚血発作	意識消失
乳児白血病	白血病	乳児偽白血病
筋委縮	筋萎縮症	筋拘縮症
左鼠経ヘルニア	鼡径ヘルニア	縦隔ヘルニア
糖尿病神経症	糖尿病性神経痛	糖尿病性末梢神経障害
左室低形成	左心低形成症候群	右室低形成
分岐部動脈瘤	内頚動脈後交通動脈分岐部動脈瘤	上肢動脈瘤
悪性腫瘍スクリーニング	悪性腫瘍	悪性軟部腫瘍
右踵骨折	骨折	踵骨骨折
ＰＰＨ	肺高血圧症	ＰＣＷＨ
子宮間質肉腫	肉腫	子宮肉腫
右主気管支膜様部壊死	壊死	開放性気管支損傷
右下肺野スリガラス影	胸部異常陰影	下肺野陰影
胆嚢腺扁平上皮癌	癌	肺腺扁平上皮癌
突発性血小板減少性紫斑病	血小板減少性紫斑病	続発性血小板減少性紫斑病
左閉鎖リンパ節転移	リンパ節転移	多部位リンパ節転移
胃癌多発肝転移	転移性肝癌	肝癌骨転移
左前腕浮腫	浮腫	上腕浮腫
偽腔閉塞型大動脈解離	解離性大動脈瘤	解離性動脈瘤
高度感音性難聴	感音難聴	両側性感音難聴
胆嚢腫瘍	胆のう腫瘍	胆管腫瘍
胃がん	胃癌	胃びらん
左中大脳動脈梗塞	中大脳動脈塞栓症	脳外主幹動脈閉塞脳梗塞
眠前発熱	発熱	七日熱
四肢色素沈着	皮膚色素沈着	角膜色素沈着
三角圧痛	肩部筋痛	圧痛
乳癌局所再発	乳癌	乳癌再発
両側顎下腺腫大	顎下腺肥大	顎下腺多形腺腫
ビタミンＤ不足	ビタミンＤ欠乏症	ビタミンＤ過剰症
日中下痢便	下痢症	食事性下痢
胸郭低形成	胸郭異常	胸郭変形
肺スリガラス陰影	胸部異常陰影	肺野円形陰影
口蓋腫瘤	腫瘤	舌根腫瘤
パーキンソン病関連疾患	パーキンソン病	若年性パーキンソン病
グラム陰性桿菌菌血症	グラム陰性桿菌敗血症	グラム陽性桿菌感染症
白内障手術	白内障	白内障術後
カルボプラチンアレルギー	薬物過敏症	ラテックスアレルギー
肺原発ホジキンリンパ腫	ホジキンリンパ腫	肺ＭＡＬＴリンパ腫
重度精神運動発達遅滞	混合性特異的発達障害	自閉性精神発達遅滞
筋緊張高く	筋強直	筋緊張性障害
母指潰瘍治癒遅延	皮膚潰瘍	手指難治性皮膚潰瘍
歩行時呼吸困難感	労作時呼吸困難	夜間呼吸困難
痰症状	喀痰	膿性痰
腸管血流障害	末梢循環障害	小腸血管形成異常
全身性単純ヘルペスウイルス感染症	ヘルペスウイルス感染症	先天性ヘルペスウイルス感染症
劇症型腸アメーバ症	腸アメーバ症	慢性腸アメーバ症
不適応行動	適応障害	異常行動
腹膜播種結節摘出	腹膜播種	胸膜播種
緑色痰	喀痰	膿性痰
ポンプポケット内血腫	血腫	絨毛膜下血腫
尿量低下	乏尿	低張尿
むつかぶれ	おむつ皮膚炎	こむら返り
水平亜脱臼	亜脱臼	水晶体脱臼
早期癌	癌	末期癌
吻合部出血	出血	口腔出血
子宮頸がん	子宮頚癌	子宮頚部びらん
腺扁平上皮癌	癌	卵巣扁平上皮癌
喉頭蓋サルコイドーシス	サルコイドーシス	鼻腔サルコイドーシス
声門部狭窄	喉頭狭窄症	処置後声門下狭窄
頭蓋底髄膜腫	髄膜腫	中頭蓋窩髄膜腫
膵全体癌	膵癌	膵体部癌
穿刺部位出血	出血	外陰部出血
手掌黄色腫	黄色腫症	手掌腫脹
皮膚湿疹	湿疹	全身湿疹
非吻合部多発胆管狭窄	胆管狭窄症	重複胆管
左腎嚢胞不変	腎のう胞	過剰腎
軽度発赤腫脹	発赤	限局性皮下腫脹
左手首痛	手部痛	後足部痛
続発性赤芽球癆	赤芽球ろう	新生児赤芽球症
インフルエンザ菌	インフルエンザ	インフルエンザ菌感染症
左舌区小細胞癌	小細胞肺癌	前立腺小細胞癌
成人発症Ｓｔｉｌｌ病（ＡＯＳＤ）	成人スチル病	ＴｒｉｐｌｅＡ症候群
大球性正色素性貧血	正色素性貧血	正球性正色素性貧血
Ｓ状結腸高分化腺癌	Ｓ状結腸癌	Ｓ状結腸神経内分泌細胞癌
両下肢痛み	疼痛	下肢痛
ＳＭＡ浸潤	膵癌	脊髄性筋萎縮症
高Ｃｌ血症	高クロール血症	高ＬＤＬ血症
乳頭状腺癌	癌	甲状腺乳頭癌
帯状疱疹ウイルス脊髄炎	ウイルス脊髄炎	帯状疱疹性脊髄炎
内臓播種性ＶＺＶ感染症	汎発性帯状疱疹	水痘・帯状疱疹ウイルス感染母体より出生した児
様皮疹	発疹	間擦疹
骨形成不全症Ⅲ型	骨形成不全症	骨形成不全症２型
高度肥満症	病的肥満症	肥満症
右前頭葉脳内血腫	血腫	外傷性脳内血腫
四肢関節腫脹	関節炎	足関節腫脹
右腸骨静脈血栓症	腸骨静脈圧迫症候群	腸骨動脈血栓症
眼瞼結膜軽度貧血	貧血	眼瞼結膜出血
子宮頸癌Ⅲｂ期	子宮頚癌	子宮峡部癌
肝内腫瘤性病変	腫瘤	肝腫瘤
ＡＳＤ	心房中隔欠損症	自家感作性皮膚炎
緑膿菌肺感染症	緑膿菌肺炎	緑膿菌感染症
ふらつきあり転倒リスク高い	めまい	筋力低下
食道癌術後リンパ節転移	リンパ節転移	食道癌骨転移
亜急性期小脳梗塞	小脳梗塞	多発性小脳梗塞
喘息コントロール	咳喘息	アトピー性喘息
右膝違和感	全身違和感	足関節強直
中高分化型腺癌	癌	甲状腺未分化癌
身体外傷	外傷	頭部外傷
神経根性痛	疼痛	神経痛
白色壊死組織付着	壊死	骨髄性類白血病反応
夜間中途覚醒	睡眠障害	非器質性睡眠・覚醒スケジュール障害
無涙症	涙液分泌不全	無汗症
ｃｒｉｔｉｃａｌ　ｉｌｌｎｅｓｓ　ｐｏｌｙｎｅｕｒｏｐａｔｈｙ	多発ニューロパチー	ＴｒｉｐｌｅＡ症候群
水疱瘡	水疱症	水疱性類天疱瘡
水様便流出	下痢症	血便
Ｅｎｔａｍｏｅｂａ　ｈｉｓｔｏｌｙｔｉｃａ	アメーバ赤痢	ＣＡＤＡＳＩＬ
大腿筋横紋筋肉腫	横紋筋肉腫	大腿横紋筋肉腫
腸炎性関節炎	関節炎	腸チフス性関節炎
ＰＭＳ	月経前症候群	多発性筋炎
腓腹部圧痛	腹部圧痛	腓腹部痛
非チフス性Ｓａｌｍｏｎｅｌｌａ菌血症	菌血症	ＥＳＢＬ産生菌感染症
微小多発肝膿瘍	肝膿瘍	多発性肝膿瘍
輪状披裂関節炎	関節炎	輪状披裂関節捻挫
左下肢蜂窩織炎	下肢蜂巣炎	蜂窩織炎
咽頭残留	嚥下障害	咽頭腐蝕
大量水様下痢	下痢症	非感染性下痢
処方右乳癌	乳癌	術後乳癌
症候性けいれん	症候性てんかん	難治性てんかん
呼吸機能低下	呼吸機能検査異常	呼吸困難
右大腿リンパ節転移	リンパ節転移	骨盤内リンパ節転移
左第３趾潰瘍	趾皮膚潰瘍	母趾皮膚潰瘍
膝関節水腫	膝関節水症	肘関節水腫
好酸球性胆嚢炎	胆のう炎	自己免疫性胆管炎
左下腿骨幹部骨折	骨折	大腿骨骨幹部骨折
ふらつき有	めまい	ふるえ
結核性ブドウ膜炎	結核性ぶどう膜炎	結核性硬膜炎
痙直型四肢麻痺	四肢麻痺	痙性四肢麻痺
角化性紅斑散在	紅斑症	新生児紅斑
慢性腎炎	慢性腎炎症候群	慢性腎盂腎炎
左側頭葉皮質化出血	出血	前額部皮下出血
右足底腱膜炎	足底筋膜炎	膝部腱膜炎
高～中分化型管状腺癌	癌	甲状腺未分化癌
左大腿部蜂窩織炎	大腿部蜂巣炎	蜂窩織炎
下肢対麻痺	対麻痺	下肢単麻痺
成長発達遅滞	発達遅滞	成長障害
下腿点状出血	点状出血	腰部皮下出血
脈管奇形	奇形	先天性卵管奇形
可動時痛	疼痛	睡眠時頭痛
右鼠経ヘルニア修復術	鼡径ヘルニア	術後食道裂孔ヘルニア
腎前性脱水	脱水症	腎結石性閉塞を伴う水腎症
頸部皮下膿瘍	皮膚膿瘍	多発皮下膿瘍
ウイルス性感冒	感冒	ウイルス感染症
腹部自発痛	腹痛症	側腹部痛
中分化型前立腺癌	前立腺癌	進行性前立腺癌
褥瘡形成リスク高い	褥瘡	褥瘡・ＤＴＩ
手術高血圧	高血圧症	術中低血圧
嚥下下困難	嚥下障害	嚥下困難
てんかん脳波	異常脳波	脳炎後てんかん
腹水多量貯留	腹水症	胸水貯留
瘢痕痙性	瘢痕	萎縮性瘢痕
両Ｔ字杖歩行	歩行障害	内反歩行
出血付着程度	出血	出血傾向
右海綿静脈洞髄膜腫	髄膜腫	傍矢状洞髄膜腫
壊死性筋炎	筋炎	壊死性筋膜炎
軽度構音障害	構音障害	機能性構音障害
二次性副腎不全	副腎クリーゼ	急性腎性腎不全
一週間程度眠気	非器質性過眠症	慢性眠剤中毒
子宮内腔癒着	子宮内膜症	子宮付属器癒着
右母指陳旧性尺側側副靱帯損傷	靱帯損傷	陳旧性母指側副靱帯損傷
皮膚型ＰＮ	結節性多発動脈炎	皮膚結節性多発動脈炎
副鼻腔軽度粘膜肥厚	副鼻腔炎	頚管粘膜肥厚
骨粗鬆症性圧迫骨折	骨粗鬆症・病的骨折あり	陳旧性圧迫骨折
右肺原発肺腺癌	肺腺癌	原発性肺癌
脊髄原発悪性リンパ腫	悪性リンパ腫	悪性リンパ腫骨髄浸潤
手指浮腫	浮腫	足部浮腫
皮質性認知症	皮質下認知症	皮質認知症
足背発赤	発赤	下腿発赤
後縦隔腫瘤	縦隔腫瘍	横隔膜腫瘤
頚椎症性脊椎症	脊椎症	頚椎症性脊髄症
中部延髄右外側脳梗塞	脳梗塞	脳幹梗塞・急性期
仙骨部瘻孔	難治性瘻孔	腹壁瘻孔
右傍気管リンパ節転移	リンパ節転移	気管支リンパ節転移
ｓｍａｌｌ　ｃｅｌｌ　ｃａｒｃｉｎｏｍａ	癌	ＣＡＲＡＳＩＬ
遺伝性出血性毛細血管拡張症	オスラー病	毛細血管拡張症
右肺門部原発	原発性肺癌	代償性肺気腫
元々頻尿	頻尿症	多尿
核下性顔面神経麻痺	顔面神経麻痺	陳旧性顔面神経麻痺
皮膚原発悪性リンパ腫	悪性リンパ腫	皮膚Ｔ細胞リンパ腫
市中感染型ＭＲＳＡ	ＭＲＳＡ感染症	ＭＲＣＮＳ感染症
乾性咳嗽頻回	乾性咳	慢性咳嗽
首痛	頚部痛	頚性頭痛
右側頭部紫斑	紫斑病	老人性紫斑
薬剤過敏性症候群	薬物過敏症	薬剤性過敏症症候群
子宮筋腫核出後妊娠	妊娠	子宮筋層内妊娠
軟骨損傷	肋軟骨損傷	距骨骨軟骨損傷
右副腎原発	副腎腫瘍	副腎性器症候群
ｋｌｅｂｓｉｅｌｌａ　ｐｎｅｕｍｏｎｉａｅ感染症	クレブシェラ属感染	ＭＮＧＩＥ
めまい軽度	めまい	めまい症
右横隔膜筋欠損	筋欠損	横隔膜欠損
漿膜損傷	損傷	結膜腐蝕
ふらつき目立	めまい	顔面せつ
近位筋痛	筋肉痛	項背部筋痛
ノカルジア脳膿瘍	ノカルジア症	小脳脳膿瘍
右前腕皮疹	発疹	四肢発疹
後腹膜浸潤	後腹膜悪性腫瘍	腹膜中皮腫
網状紫斑	紫斑病	網膜色素斑
胚細胞腫瘍	腫瘍	脳胚細胞腫瘍
ゲノタイプ１ｂ型Ｃ型肝硬変	Ｃ型肝硬変	Ｂ型肝硬変
類円形腫大	リンパ節腫大	角化棘細胞腫
小股歩行	歩行異常	内転歩行
糖尿病末梢神経障害	糖尿病性単ニューロパチー	糖尿病性末梢神経障害
ルンバール後頭痛	腰椎穿刺後頭痛	頭痛
急性重症Ｂ型肝炎	Ｂ型肝炎	Ｂ型急性肝炎
下垂時疼痛	疼痛	下肢痛
頚部蜂窩織炎	頚部蜂巣炎	蜂窩織炎
腹満不変	腹部膨満	腹部不快感
一過性心筋虚血	心筋虚血	新生児一過性心筋虚血
日勤帯発熱	発熱	新生児発熱
結核性喉頭狭窄	喉頭狭窄症	喉頭結核
両側鼻内ポリープ	鼻茸	後鼻孔ポリープ
手掌潮紅	紅潮	手掌紅斑
離床時眩暈	めまい	起立性眩暈
高齢者Ｃ型慢性肝炎	Ｃ型慢性肝炎	Ｂ型慢性肝炎
軽度咽頭違和感	咽頭異常感症	咽喉頭異常感症
体熱感	不明熱	熱中症
閉塞性大腸癌	大腸癌	遺伝性大腸癌
両側大腰筋血腫	血腫	頭部血腫
ＰＳＬＮ転移	大動脈周囲リンパ節転移	骨髄転移
咽頭部疼痛	咽頭痛	慢性咽頭痛
肺腫瘍塞栓症	肺腫瘍	肺塞栓症
４型進行胃癌	胃進行癌	早期胃癌
圧迫性脊髄症	脊髄症	脊髄圧迫症
カルチノイド腫瘍	カルチノイド	キュットネル腫瘍
心臓内腫瘤	腫瘤	頭部腫瘤
日中気分不快	悪心	反復性気分障害
けいれん再発	痙攣	再発性角膜びらん
遊走性静脈炎	遊走性血栓性静脈炎	上肢静脈炎
直腸癌術後異時性肝転移	転移性肝癌	肝癌骨転移
手指痺れ	しびれ感	手指欠損症
左卵管水腫	卵管留水症	胎児水腫
歩行時呼吸困難	労作時呼吸困難	夜間呼吸困難
ガーゼ出血	出血	第３期出血
右被殻脳梗塞	被殻出血	小脳梗塞
子宮頚部嚢胞	子宮頚部腫瘍	子宮頚部細胞診・軽度扁平上皮内病変
腺腫内癌	癌	大腸腺腫内癌
膣転移	腟癌	転移性膀胱癌
左小脳陳旧性梗塞	陳旧性脳梗塞	陳旧性小脳梗塞
淡黄色粘稠痰	喀痰	膿性痰
左末梢性肺動脈狭窄	肺動脈狭窄症	末梢性肺動脈狭窄症
骨代謝異常	代謝障害	骨内異物残留
心陰影拡大	胸部異常陰影	異常心陰影
腎動脈下腹部大動脈瘤	腹部大動脈瘤	腎動脈瘤
腸管壁内気腫	皮下気腫	口腔粘膜下気腫
慢性活動性ＥＢＶ感染症	ＥＢウイルス感染症	ＢＬＮＡＲ感染症
足関節圧痛	関節痛	足関節痛
顔面紅班	紅斑症	顔面紅潮
排便痛	排便障害	便異常
両下肢リンハ゜浮腫	下肢リンパ浮腫	上肢浮腫
左頸部ＬＮ腫脹	肘リンパ節腫脹	後頭部リンパ節腫脹
肺門部リンパ節腫脹	リンパ節腫大	肺門リンパ節腫脹
呼吸困難感軽度	呼吸麻痺	呼吸困難
左膝窩動脈血栓症	動脈血栓症	腋窩動脈血栓症
内鼠径ヘルニア	内鼡径ヘルニア	上腹壁ヘルニア
開口制限	開口不全	開口障害
鼠径部血腫	血腫	頭部血腫
暗赤色嘔吐	嘔吐症	糞便性嘔吐
左増殖性糖尿病網膜症	糖尿病網膜症	増殖性糖尿病性網膜症
レム睡眠行動異常	異常行動	レム睡眠行動障害
声帯癌	声門癌	仮声帯癌
直腸皮下瘻孔	難治性瘻孔	乳腺瘻孔
胆嚢腫大	胆のう肥大	総胆管腫瘍
Ｈｅｅｒｆｏｒｄｔ症候群	ぶどう膜耳下腺熱	ＭＥＲＲＦ症候群
ダグラス窩腹水	腹水症	血性腹水
失見当障害	見当識障害	先端失認症
ツツガムシ感染症	つつが虫病	アニサキス幼虫感染症
前立腺浮腫	浮腫	内分泌性浮腫
胞性腫瘤	腫瘤	精索腫瘤
右鼠径リンパ節腫脹	鼡径部リンパ節腫脹	後頭部リンパ節腫脹
ＡＡＡ破裂	腹部大動脈瘤	腹部大動脈瘤破裂
夜間覚醒	不眠症	幻覚
初発癌	癌	末期癌
機会誤嚥	嚥下障害	異物誤嚥
大腿静脈血栓	静脈血栓症	大腿静脈血栓症
新生血管緑内障	緑内障	血管新生緑内障
アメーバ肝膿瘍	肝アメーバ症	アメーバ性肝膿瘍
先天性真珠腫	真珠腫	仮性真珠腫
右肺門部浸潤影	胸部異常陰影	下肺野陰影
食道悪性腫瘍	食道癌	食道良性腫瘍
レントゲン異常	胸部異常陰影	フィブリノゲン異常症
器質的心疾患	心疾患	先天性心疾患
低酸素症状	低酸素性脳症	低酸素血症
粘稠痰少量	喀痰	膿性痰
ダンベル型腫瘍	腫瘍	葉状腫瘍
催不整脈作用	不整脈	不随意痙攣性運動
左腋窩汗腺癌	汗腺癌	腋窩皮膚癌
感染性仮性嚢胞	仮性膵のう胞	新生児皮膚感染症
乳房熱感	ほてり	乳房熱傷
大腸穿孔	腸穿孔	小腸穿孔
腎瘢痕	瘢痕	腎瘻
進行性顔面片側萎縮症	顔面痙攣症	顔面半側萎縮症
非逆流性食道炎	食道炎	逆流性食道炎
甲状腺萎縮	後天性甲状腺萎縮	先天性甲状腺萎縮
呼吸苦自覚症状	呼吸困難	急性呼吸窮迫症候群
多発単神経障害	多発性単ニューロパチー	多発性神経障害
右肺上葉結節影	胸部異常陰影	下肺野陰影
アルコール性脂肪性肝炎	アルコール性脂肪肝	非アルコール性脂肪性肝炎
脳室穿破	脳出血	脳梁欠損症
鼠径部リンパ節腫大	鼡径部リンパ節腫脹	リンパ節腫大
両側乳房腫瘤	乳房腫瘤	乳房乳頭部腫瘤
原発不明癌頸部リンパ節転移	頚部リンパ節転移	多発性癌転移
右下葉原発扁平上皮癌	下葉肺扁平上皮癌	上葉肺扁平上皮癌
潜血３	顕微鏡的血尿	血友病性出血
アレルギー性血管浮腫	浮腫	アレルギー性浮腫
顕微的血尿	血尿	顕微鏡的血尿
日中痛み	疼痛	全身痛
眼球運動痛	疼痛	眼球運動痙攣
Ｙｅｒｓｉｎｉａ　ｅｎｔｅｒｏｃｏｌｉｔｉｃａ感染症	エルシニア菌食中毒	Ｅｕｔｈｙｒｏｉｄ　Ｓｉｃｋ症候群
チクチク痛む	チクチク感	鈍痛
多発肺内転移	転移性肺癌	転移性肺腫瘍
左下葉肺癌断端再発	下葉肺癌	上葉肺癌
糖尿病性自律神経障害	糖尿病性自律神経ニューロパチー	糖尿病性末梢神経障害
卵巣嚢腫破裂	卵巣のう腫破裂	卵巣腫瘍破裂
抗原血症	サイトメガロウイルス感染症	循環性抗凝血因子症
甲状軟骨浸潤	甲状軟骨の悪性腫瘍	甲状軟骨裂
潜在性副腎皮質機能低下症	副腎皮質機能低下症	続発性副腎皮質機能低下症
眼球陷凹	眼球陥没	眼球ろう
左鎖骨下リンパ節転移	リンパ節転移	鎖骨上リンパ節転移
両眼糖尿病性網膜症	糖尿病網膜症	２型糖尿病性網膜症
右第１趾潰瘍	趾皮膚潰瘍	母趾皮膚潰瘍
踵部発赤	発赤	下腿発赤
両側ぶどう膜炎	ぶどう膜炎	中間部ぶどう膜炎
痔疾患	痔核	痔瘻
無疱疹帯状疱疹	帯状疱疹	後頭部帯状疱疹
吐き気軽度	嘔気	嘔吐症
非結核性抗酸菌性人工関節感染症	非結核性抗酸菌症	非結核性抗酸菌性股関節炎
前胸痛	胸痛	前胸部痛
結腸皮膚瘻	皮膚瘻	結腸瘻
患肢熱感	ほてり	下肢冷感
潜血	顕微鏡的血尿	出血
細菌性脳動脈瘤破裂	脳動脈瘤破裂	先天性脳動脈瘤破裂
右鼡径部皮下出血	皮下出血	頭部皮下出血
右下腿筋肉内出血	筋肉内血腫	腰部皮下出血
気分悪	悪心	気分変調症
遠位弓部嚢状動脈瘤	動脈瘤	弓部大動脈瘤
造骨性骨転移	骨転移癌	骨盤転移
失調性構音障害	構音障害	発達性構音障害
皮疹拡大傾向	発疹	扁平湿疹
右足底部蜂窩織炎	足蜂巣炎	蜂窩織炎
朝方痰	喀痰	過剰喀痰
軽度すりガラス影	胸部異常陰影	コイン状陰影
二次性血小板増多症	血小板増加症	二次性血小板増加症
労作時頻脈	頻脈症	労作性狭心症
重症胆管炎	胆管炎	慢性胆管炎
右側胸部痛	胸痛	側胸部痛
呂律のまわりにくさ	構音障害	排便習慣の変化
アミオダロン誘発性甲状腺中毒症	薬剤性甲状腺機能障害	人為的甲状腺中毒症
左胸部痛	胸痛	胸背部痛
左下腿ＤＶＴ	下腿静脈血栓症	ＨＤＬＳ
致死性不整脈出現	不整脈	絶対性不整脈
一瞬痛み	疼痛	全身痛
難治性皮膚非定型抗酸菌症	非結核性抗酸菌症	皮膚非結核性抗酸菌症
頚部鈍痛	鈍痛	頚部痛
右肺上葉陰影	胸部異常陰影	下肺野陰影
右上葉肺結節	結節性肺結核	大葉性肺炎
味覚変化	味覚障害	味覚消失
凝固異常症	血液凝固異常	消費性凝固障害
両側下顎骨折	下顎骨骨折	下顎頭骨折
多発性肝腫瘤	肝腫瘍	肝腫瘤
意味性錯語	文意失語症	錯味
ｃｏａｒｓｅ　ｃｒａｃｋｌｅｓ	湿性ラ音	ＣＡＲＡＳＩＬ
緑色下痢便	下痢症	白色便性下痢症
ＡＶブロック	房室ブロック	ＡＶＭ
外側脱臼	脱臼	前方脱臼
左殿部疼痛	殿部痛	急性疼痛
両足しびれ	下肢しびれ	四肢しびれ
膜性増殖性	膜性増殖性糸球体腎炎	強膜拡張症
頻脈性心房粗動	心房粗動	頻脈性心房細動
実質外腫瘤	腫瘤	下垂体腫瘤
重症低体温症	低体温	新生児低体温症
関節炎悪化	関節炎	慢性関節炎
右尖足	尖足	内反尖足
両手指浮腫	浮腫	足部浮腫
浸潤癌化	癌	肺未分化癌
就寝後呼吸困難	呼吸困難	夜間呼吸困難
訪室時疼痛	疼痛	難治性疼痛
軽度黄染	黄疸	黄斑症
転移性膵癌	膵癌	膵臓癌骨転移
間歇跛行	間欠性跛行	跛行
動脈瘤コイル塞栓術	動脈瘤	動脈塞栓症
右膝疼痛	膝関節痛	膝窩部痛
皮内腫瘍	腫瘍	皮下腫瘍
左前床突起部髄膜腫	髄膜腫	前頭髄膜腫
軽度腹部痛	腹痛症	上腹部痛
多発毛細血管拡張	オスラー病	毛細血管拡張症
左肺動脈ＰＥ	肺動脈血栓塞栓症	汎小葉性肺気腫
胃潰瘍再発	胃潰瘍瘢痕	再発性胃潰瘍
境界域精神発達遅滞	知的障害	自閉性精神発達遅滞
外陰部ｐａｇｅｔ癌	外陰部パジェット病	外陰部アポクリン腺癌
リウマチ様症状	関節リウマチ	回帰性リウマチ
骨盤位妊娠	骨盤位	骨盤位分娩
左椎間孔狭窄	結合組織性椎間孔狭窄症	骨性椎間孔狭窄症
前立腺軽度腫大	前立腺肥大症	下垂体巨大腺腫
大腸憩室症	多発性大腸憩室症	小腸憩室症
右腹痛	腹痛症	下腹痛
嚥下耳痛	耳痛症	嚥下痛
茶色出血	出血	出血性貧血
左下葉扁平上皮癌	下葉肺扁平上皮癌	上葉肺扁平上皮癌
原発性ヘモクロマトーシス	ヘモクロマトーシス	続発性ヘモクロマトーシス
逆行性Ｐ波	心電図異常	反射性瞳孔強直
臀部圧痛	圧痛	腹部圧痛
多発皮下転移	皮下腫瘍	転移性皮膚腫瘍
副鼻腔病変	副鼻	副鼻腔異物
安静時呼吸苦	呼吸困難	急性呼吸不全
陰嚢疼痛	陰のう痛	陰茎部疼痛
上眼瞼腫脹	眼瞼浮腫	眼瞼外傷性腫脹
右下肢複雑骨折	開放骨折	下肢多発骨折
両頬部発赤	発赤	下腿発赤
感染性肝嚢胞	肝のう胞	巨大肝蛭感染症
皮下出血斑	皮下出血	下肢出血斑
右下腿骨髄炎	大腿骨骨髄炎	下腿骨骨髄炎
平行機能障害	平衡異常	多動性素行障害
元々杖歩行	歩行障害	歩行異常
毎回失禁	尿失禁症	過敏症
非医原性左尿管狭窄	尿管狭窄	先天性尿管狭窄症
下腿血腫	血腫	下腿部皮下血腫
逆流性膀胱炎	膀胱尿管逆流	反復性膀胱炎
覚醒時疼痛	疼痛	術後疼痛
左大転子部発赤	発赤	手掌部悪性黒色腫
リンパ腫再発	悪性リンパ腫	リンパ腫
重度運動障害性構音障害	構音障害	運動障害性構音障害
癌性胸腹膜炎	癌性腹膜炎	癌性胸膜炎
帯状疱疹ウイルス脳炎	帯状疱疹性脳炎	帯状疱疹性髄膜脳炎
齲蝕	う蝕	弯曲歯
腎性急性腎障害	腎障害	急性腎性腎不全
喉頭嚢胞	喉頭のう胞	喉頭蓋のう胞
左上下肢しびれ	半身しびれ	下肢しびれ
心筋傷害	心筋疾患	心筋虚血
胆嚢胆石	胆泥	胆のう潰瘍
縱隔リンパ節転移	縦隔リンパ節転移	鼡径部リンパ節転移
悪性細胞	癌	精巣悪性腫瘍
Ｌｉｓｔｅｒｉａ　ｍｏｎｏｃｙｔｏｇｅｎｅｓ敗血症	敗血症	リステリア性敗血症
左下肢原発性リンパ浮腫	リンパ浮腫	上肢リンパ浮腫
落ち着かない	多動性障害	落ち込み
苦悶症状	胸内苦悶	倦怠感
周術期喘息発作	気管支喘息発作	夜間性喘息
薬剤性副腎不全	副腎皮質機能低下症	薬剤性腎障害
乳がん	乳癌	乳頭びらん
右上顎洞真菌症	上顎洞炎	副鼻腔真菌症
右足滑液包炎	滑液包炎	膝蓋前滑液包炎
隆起性病変	胃ポリープ症	線溶亢進
腫瘤状構造	腫瘤	頭頂部腫瘤
細菌性赤痢感染症	赤痢	ボイド菌赤痢
多数骨折	骨折	多発骨折
３型進行癌	癌	末期癌
全頭脱毛症	脱毛症	完全脱毛症
ｆａｎ症候群	マルファン症候群	ＣＦＣ症候群
脊椎椎間板炎	椎間板炎	頚椎椎間板炎
起始異常	冠動脈起始異常	異常行動
ふらつき感自覚	よろめき歩行	片側感覚鈍麻
腎嚢胞出血	傍腎盂のう胞	腎周囲出血
無症候性キャリア	ＨＴＬＶ−１キャリア	ＨＣＶキャリア
中等度腹水	腹水症	異常腹水
受容体脳炎	抗ＮＭＤＡ受容体脳炎	脳炎
肛門部軽度発赤	肛門部周囲炎	咽頭発赤
側方リンパ節転移	リンパ節転移	多部位リンパ節転移
統合失調症既往	統合失調症	統合失調症型障害
肺腫瘤影	胸部異常陰影	肺腫瘤陰影
複雑型異型子宮内膜増殖症	腺腫性子宮内膜増殖症	複雑型子宮内膜異型増殖症
肝肥大	肝型糖原病	脂肪肝
腰部圧痛	腰痛症	腹部圧痛
肺血症性ショック	敗血症性ショック	ショック肺
凝固線溶系異常	血液凝固異常	消費性凝固障害
異所性静脈瘤	静脈瘤	先天性静脈瘤
腫瘍崩壊	腫瘍	腫瘍崩壊症候群
破壊性甲状腺炎	甲状腺炎	亜急性甲状腺炎
右腎被膜下血腫	血腫	外傷性腎被膜下血腫
脱分化型脂肪肉腫	脂肪肉腫	精索脂肪肉腫
非機能性下垂体腫瘍	下垂体腫瘍	悪性下垂体腫瘍
ＡＣＴＨ分泌不全	ＡＣＴＨ分泌低下症	副腎皮質刺激ホルモン不応症
小人症	低身長症	小頭症
右臼蓋転移	骨盤転移	脊椎転移
右眼網膜症	網膜症	近視性網膜症
右下葉肺扁平上皮癌	下葉肺扁平上皮癌	上葉肺扁平上皮癌
足趾壊疽	趾壊死	足壊疽
左肺尖部腺癌	肺腺癌	肺門部腺癌
潰瘍型間質性膀胱炎	間質性膀胱炎	潰瘍性膀胱炎
紅色皮疹	発疹	紅色丘疹
遺尿	遺尿症	全遺尿
頚管狭窄	子宮頚管狭窄症	頚部脊柱管狭窄症
脳梗塞後後遺症	脳梗塞	脳梗塞後遺症
紅斑熱	日本紅斑熱	温熱性紅斑
多発頭蓋骨転移	骨転移癌	転移性頭蓋骨腫瘍
運動低下性構音障害	構音障害	運動障害性構音障害
両側腸腰筋血腫	血腫	頭部血腫
肝嚢胞感染	肝のう胞	巨大肝蛭感染症
顔面骨圧痛	圧痛	顔面痛
会陰部疼痛	外陰部痛	陰茎部疼痛
２次性副甲状腺機能亢進症	副甲状腺機能亢進症	続発性副甲状腺機能亢進症
右上腕蜂窩織炎	上腕蜂巣炎	蜂窩織炎
右前大脳動脈未破裂動脈瘤	前大脳動脈瘤	未破裂脳動脈瘤
リウマチ性胸水	リウマチ性肺疾患	血性胸水
右眼白内障手術	白内障	白内障術後
悪性リンハ゜腫	悪性リンパ腫	鼡径部悪性黒色腫
右基底核梗塞	脳梗塞	皮質枝梗塞
リウマチ疾患	関節リウマチ	回帰性リウマチ
心房細動停止	心房細動	慢性心房細動
ＶＨＬ病	フォンヒッペル・リンダウ病	ＨＤＬＳ
陰嚢部腫脹	陰のう腫大	前胸部腫脹
高分化型腺癌	癌	甲状腺未分化癌
Ｍｙｃｏｂａｃｔｅｒｉｕｍ　ｓｈｉｇａｅｎｓｅ感染症	非結核性抗酸菌症	エンテロバクター属感染
両側肺動脈血栓塞栓	動脈血栓症	肺動脈血栓塞栓症
左耳耳鳴	耳鳴症	頚性耳鳴
鼠経ヘルニア	鼡径ヘルニア	縦隔ヘルニア
完全型ベーチェット病	ベーチェット病	不全型ベーチェット病
筋肉痙攣	痙攣	四肢筋痙攣
癌性髄膜腫症	悪性髄膜腫	髄膜癌腫症
化膿性脊椎椎間板炎	化膿性椎間板炎	化膿性脊椎炎
呼吸性雑音	胸部音異常	拡張期雑音
両肩関節圧痛	圧痛	肩関節痛風
多発肝細胞癌	肝腫瘍	肝細胞癌
右腎小嚢胞	傍腎盂のう胞	副腎のう胞
左横隔膜神経麻痺	横隔神経麻痺	横隔膜麻痺
右高度水腎症	水腎症	先天性水腎症
進行性食道癌	食道癌	早期食道癌
大腿骨近位部骨折	大腿骨骨折	大腿骨遠位端骨折
刺激性皮膚炎	皮膚炎	虫刺性皮膚炎
回腸閉塞	回腸狭窄	回腸閉鎖
尾部嚢胞	膵のう胞	鰓のう胞
虫刺症	蜂刺症	刺虫症
膵仮性嚢胞破裂	仮性膵のう胞	閉鎖性膵臓破裂
シェーンラインヘノッホ紫斑病	ＩｇＡ血管炎	クリオグロブリン血症性紫斑病
チャーグ－ストラウス症候群	好酸球性多発血管炎性肉芽腫症	アダムス・ストークス症候群
低ＡＴⅢ血症	アンチトロンビン欠乏症	遺伝性血小板減少症
超皮質性感覚性失語	皮質下感覚性失語症	超皮質性失語
ＮＯＭＩ	腸壊死	ＭＮＧＩＥ
左踵骨裂離骨折	踵骨骨折	中手骨裂離骨折
慢性糸球体炎	糸球体腎炎	急性毛様体炎
左腰部有棘細胞癌	腰部有棘細胞癌	前胸部有棘細胞癌
四肢圧痛	圧痛	四肢痛
関節変形	関節奇形	股関節変形
気分変動	気分変調症	気分異常
食道カンジタ症合併ＨＩＶ感染症	ＨＩＶカンジダ病	ＥＢウイルス関連免疫不全症
固縮無動	こわばり	動揺肩
生検部感染徴候	創傷感染症	生検後感染
右眼下鼻側視野異常	視野障害	単眼性視力障害
右肺Ｓ４原発腺癌	肺腺癌	上葉肺腺癌
喘息コントロール不良	咳喘息	アトピー性喘息
腹部大動脈狭窄症	大腿動脈狭窄症	腹部大動脈閉塞症
大腸疾患	腸疾患	大腸重積症
頚部血腫	頚部表在損傷	頭部血腫
肺雑聴取	胸部音異常	肺過誤腫
皮下浮腫	浮腫	下肢浮腫
右内頸動脈血栓閉塞	動脈血栓症	末梢動脈塞栓症
ＣＮＩ腎症	薬剤性腎障害	ＩｇＡ腎症
胃液様	嘔吐症	胃液分泌過多
右鼡径部出血	出血	腟断端出血
右肺上葉肺炎	肺炎	大葉性肺炎
門亢症	門脈圧亢進症	陰門疾患
創内異物	外傷性異物	軟部組織内異物
肢痛	疼痛	下肢痛
腸管内血腫	血腫	消化管血腫
前胸部粉瘤	粉瘤	前胸部腫瘤
完全右脚ブロック指摘	完全右脚ブロック	不完全右脚ブロック
末節骨骨折	骨折	頭頂骨骨折
脊椎症性変化	脊椎症	変形性脊椎症
腸閉塞気味	イレウス	直腸閉鎖
浅呼吸	呼吸困難	多呼吸
痛覚消失	異常知覚	片側痛覚消失
膵炎再燃	膵炎	壊死性膵炎
肘頭部潰瘍	前腕皮膚潰瘍	肘部軟部腫瘍
反復性腸閉塞	イレウス	直腸閉鎖
胎児腹水	胎児水腫	胎児胸水
皮膚ツルゴール低下	脱水症	皮膚ムコール症
右肩悪性軟部腫瘍	悪性軟部腫瘍	肩部悪性軟部腫瘍
右中指スワンネック変形肩関節	スワンネック変形	変形性肩関節症
腹部肥満	肥満症	腹部膨満
Ｓ状結腸粘膜下腫瘤	腫瘤	Ｓ状結腸粘膜下腫瘍
蛋白血症	異常蛋白血症	低蛋白血症
胸水排出	胸水貯留	漏出性胸水
ＡＩＤＳ非定型抗酸菌症	非結核性抗酸菌症	細胞性免疫不全症
尺側神経麻痺	尺骨神経麻痺	橈骨神経麻痺
てんかんの発作	てんかん	てんかん様発作
下痢〜水様便	下痢症	食事性下痢
１型糖尿除	糖尿	１型糖尿病
肺多型癌	癌	肺癌
気分不快出現	悪心	気分変調症
内腸骨静脈血栓症	静脈血栓症	腸骨動脈血栓症
舌根扁桃炎	扁桃炎	舌扁桃炎
右肺上葉小細胞癌	上葉小細胞肺癌	上葉肺大細胞癌
ＣＭＶ網膜症	サイトメガロウイルス網膜炎	ＨＩＶ網膜症
脊椎側弯症	脊柱側弯症	胸椎側弯症
脊髄視神経炎	視神経炎	視神経脊髄炎
印環細胞癌	癌	環指有棘細胞癌
左内頸動脈中等度狭窄	頚動脈硬化症	小脳動脈狭窄
ＭＬＦ症候群	核間性眼筋麻痺	ＣＦＣ症候群
肩関節疼痛	肩関節痛症	肩関節痛風
右手痺れ	上肢しびれ	手掌腫脹
逆流感	胃食道逆流症	下肢脱力感
左尿管導管吻合部狭窄	吻合部狭窄	尿管回腸導管吻合部狭窄
時折不整	不整脈	不穏状態
僧帽弁狭窄症兼閉鎖不全症	僧帽弁狭窄症	僧帽弁狭窄兼閉鎖不全症
伸筋腱脱臼	脱臼	総指伸筋腱脱臼
内転障害	眼球運動痙攣	過外転症候群
足首骨折	足関節骨折	足背骨折
高Ｂｉｌ血症	高ビリルビン血症	高ＨＤＬ血症
歩行時創部痛	術創部痛	環指痛
右足腫脹	足部腫脹	足背腫脹
脳圧亢進症状	頭蓋内圧亢進症	外傷性低脳圧症
眼鏡　近視	近視	軽度近視
二次性ヘモクロマトーシス	ヘモクロマトーシス	続発性ヘモクロマトーシス
潜在性副甲状腺機能低下症	副甲状腺機能低下症	特発性副甲状腺機能低下症
右内腸骨動脈狭窄	動脈狭窄	外腸骨動脈狭窄
両側尿管結石	尿管結石症	下部尿路結石
Ⅱａ型高脂血症	高脂血症	二次性高脂血症
右手橈骨骨折	橈骨骨折	手指中節骨骨折
右睾丸痛	精巣痛	鼡径部痛
後頭蓋下髄膜腫	髄膜腫	後頭蓋窩髄膜腫
急性前壁中隔梗塞	急性前壁中隔心筋梗塞	皮質枝梗塞
傍腹部大動脈リンパ節腫大	リンパ節腫大	限局性リンパ節腫大
尿道口発赤	発赤	亀頭部尿道下裂
労作時胸部不快	労作時呼吸困難	胸部不快感
グル音異常	異常腸音	胸部音異常
鉄吸収障害	鉄欠乏症	鉄代謝障害
本日右眼白内障	白内障	若年性白内障
処置後膵炎	膵炎	術後膵炎
ｗｉｄｅ　ＱＲＳ頻拍	頻拍症	ＨＤＬＳ
息苦しく	呼吸困難	口苦
無菌性腸炎	非感染性腸炎	細菌性腸炎
骨盤内リンパ嚢腫	骨盤部感染性リンパのう胞	骨盤内リンパ節の悪性腫瘍
平坦Ｔ波	心電図異常	胸椎症
ペーシング不全	両室ペーシング機能付き植込型除細動器不全	ペースメーカ不全
ふらつきあり	めまい	ふるえ
卵管水腫	卵管留水症	胎児水腫
左下葉原発性肺扁平上皮癌	肺扁平上皮癌	上葉肺扁平上皮癌
左乳突蜂巣炎	乳様突起炎	頭皮蜂巣炎
未破裂左内頸動脈瘤	内頚動脈瘤	未破裂脳動脈瘤
中咽頭側壁扁平上皮癌	癌	上咽頭前壁癌
両肺多発結節性陰影	胸部異常陰影	肺部異常陰影
脾臓腫瘤	腫瘤	脾腫瘍
腫瘍感染合併	腫瘍	混合腫瘍
ゾメタ骨髄炎	骨髄炎	亜急性骨髄炎
右胸膜原発血管肉腫	血管肉腫	後腹膜血管肉腫
拘縮気味	筋拘縮症	環指屈曲拘縮
手関節圧痛	圧痛	手関節痛
非てんかん性心因性発作	てんかん	心因発作
下腸間膜動脈閉塞	腸間膜動脈塞栓症	急性上腸間膜動脈閉塞症
右中大脳動脈領域梗塞	中大脳動脈閉塞症	脳外主幹動脈塞栓症脳梗塞
消化管腫瘤	腫瘤	耳介部腫瘤
脛骨前面圧痕性浮腫	浮腫	遺伝性下腿浮腫
多少眠気	非器質性過眠症	傾眠症
高濃度腫瘤	腫瘤	下垂体腫瘤
ＤＧＥ症状	消化管術後後遺症	ＭＮＧＩＥ
日光アレルギー	光線過敏症	薬物性光アレルギー性反応
両膝痛	膝関節痛	膝窩部痛
慢性炎症性腸疾患	腸炎	炎症性腸疾患
尺骨頭脱臼	脱臼	橈骨頭脱臼
けいれん症状	痙攣	てんかん
右下肢感覚鈍麻	感覚異常症	片側感覚鈍麻
慢性進行性肺アスペルギルス症	肺アスペルギルス症	慢性壊死性肺アスペルギルス症
手指皮疹	発疹	手指湿疹
残尿	残尿感	乏尿
両肺気胸	気胸	肺気腫
浮動感	めまい	動揺病
強制換気	人工呼吸器装着状態	換気量減少
喚語障害	不全失語症	発語障害
多動多弁	多動性障害	三尖弁不全
右手背浮腫	限局性浮腫	上腕浮腫
足趾しびれ	下肢しびれ	手指先しびれ
足底痺れ	しびれ感	足背捻挫
食思不振症状	食欲不振	神経性食欲不振症
細菌性食道炎	食道炎	感染性食道炎
開大代謝性アシドーシス	代謝性アシドーシス	新生児遅発代謝性アシドーシス
転移性腫瘤	転移性腫瘍	転移性縦隔腫瘍
夜間尿意	夜間頻尿症	無尿
神経性疼痛	神経痛	神経障害性疼痛
房室接合部調律	異所性調律	接合部調律
左尾状核ラクナ硬塞	ラクナ梗塞	陳旧性ラクナ梗塞
めまいの発作	めまい	めまい発作
呼吸切迫	急性呼吸窮迫症候群	呼吸促迫
劇症型連鎖球菌感染症	連鎖球菌感染症	劇症型Ａ群連鎖球菌感染症
腹部疝痛	仙痛	腹部圧痛
胆嚢多発ポリープ	胆のうポリープ	胆管ポリープ
柑皮症	カロチン血症	紅皮症
陰部掻痒	外陰部そう痒症	痒疹
前立性肥大症	前立腺肥大症	片側肥大症
夜間失禁	尿失禁症	夜盲症
褥瘡発生リスク低い	褥瘡	褥瘡感染
Ⅱ度熱傷	熱傷	第４度熱傷
重度感覚障害	体感異常	感覚異常症
炎症性ポリープ多発	ポリープ	若年性ポリープ
右坐骨結節転移再発	転移性腫瘍	転移性骨腫瘍
右上肢痺れ	しびれ感	痙性四肢麻痺
昨日水様便	下痢症	便異常
気分不快増強	悪心	気分変調症
拡張期高血圧	高血圧症	収縮期高血圧症
左頸部リンパ節腫大	薬剤性自己免疫性溶血性貧血	リンパ節腫大
右低音部感音難聴	感音難聴	急性低音障害型感音難聴
夜間失見当	見当識障害	夜驚症
劇症型髄膜炎菌感染症	髄膜炎菌感染症	侵襲性髄膜炎菌感染症
物忘れ気	健忘症	気滞
右手関節滑膜炎	滑膜炎	肘関節滑膜炎
声門上喉頭癌	喉頭癌	声門上癌
右膝メルケル細胞癌	メルケル細胞癌	前腕メルケル細胞癌
加害妄想	妄想反応	被害妄想
嚢胞性胸腺腫	胸腺腫	被包型胸腺腫
急性乳突洞炎	急性中耳炎	急性乳様突起炎
舌内リンパ節転移	リンパ節転移	腹腔リンパ節転移
左肺下葉腫瘤影	肺腫瘤	肺腫瘤陰影
Ｌ３圧迫骨折	圧迫骨折	腰椎圧迫骨折
ＣＯＰＤＩ期	慢性閉塞性肺疾患	ＰＣＷＨ
転倒歴多数	よろめき歩行	倒乱視
ＤＩＨＳ	薬疹	薬剤性過敏症症候群
インスリン依存性糖尿病	１型糖尿病	インスリン抵抗性糖尿病
頸部椎間板ヘルニア	頚椎椎間板ヘルニア	胸椎椎間板ヘルニア
拍動性疼痛	疼痛	難治性疼痛
膝関節軽度屈曲拘縮	屈曲拘縮	膝関節屈曲拘縮
ＡＴＬ	成人Ｔ細胞白血病リンパ腫	末梢性Ｔ細胞リンパ腫
肺動脈弁閉鎖不全	肺動脈弁閉鎖	肺動脈弁閉鎖不全症
熱感軽度	ほてり	熱中症
咀嚼困難感	咀嚼障害	複雑痔瘻
術後肝転移	転移性肝癌	転移性肝腫瘍
喘息疑い	咳喘息	難治性喘息
顔皮疹	発疹	顔面割創
アシネトバクター敗血症	敗血症	ＧＢＳ敗血症
左腎盂腎炎治癒後	腎盂腎炎	術後腎盂腎炎
二次性水頭症	外傷後水頭症	代償性水頭症
ダグラス窩播種	腹膜播種	胸膜播種
左室拡張能低下	左室不全	脳室拡大
動揺性めまい	めまい	回転性めまい
褥瘡発生歴	褥瘡	褥瘡感染
水分摂取困難	嚥下障害	水分欠乏症
右下葉原発低分化腺癌	癌	甲状腺未分化癌
細菌性扁桃炎	扁桃炎	連鎖球菌性扁桃炎
正常圧緑内障	緑内障	偽緑内障
梗塞後出血	出血性脳梗塞	閉経後出血
副睾丸炎	精巣炎	腟炎
慢性アレルギー性鼻炎	季節性アレルギー性鼻炎	アレルギー性鼻炎
肘痛	肘関節痛	肩部痛
単頸双角子宮	双角子宮	単頚双角子宮
原発性肺高血圧症	肺高血圧症	二次性肺高血圧症
左鎖骨リンパ節転移	リンパ節転移	鎖骨上リンパ節転移
殿部色素沈着	色素異常症	皮膚色素沈着
舌浮腫	浮腫	咽頭浮腫
舌損傷	損傷	舌外傷
腹部大動脈狭窄	大動脈狭窄症	腹部大動脈閉塞症
軽度痺れ	しびれ感	痙性麻痺
星芒状血管腫	血管腫	海綿状血管腫
右房内腫瘤	腫瘤	下垂体腫瘤
Ｓ状結腸転移	転移性消化器腫瘍	転移性直腸腫瘍
肉芽腫性腸疾患	腸疾患	結腸脂肪肉腫
両足圧痕性浮腫	浮腫	足部浮腫
発作後精神病	精神病	精神運動発作
虫垂粘液嚢胞腺腫	虫垂粘液のう胞	卵巣粘液性腺腫
若年性リウマチ	関節リウマチ	回帰性リウマチ
境界域ＤＭ	糖尿病	境界型糖尿病
骨破壊病変	関節リウマチ	恥骨骨折
眼窩部痛	眼痛	心窩部痛
口腔内発赤腫脹	発赤	口腔悪性黒色腫
中咽頭再発腫瘍	咽頭腫瘍	中咽頭良性腫瘍
リンパ管症	癌性リンパ管症	リンパ管腫症
遷延性抑うつ状態	うつ状態	遷延性抑うつ反応
結核性強膜炎	結核性胸膜炎	結核性硬膜炎
下腿筋萎縮	筋萎縮症	下肢筋萎縮
膵頭癌	癌	膵頭部癌
痰中等量引ける	喀痰	過剰喀痰
放射線障害	放射線宿酔	放射線外傷
浅眠	不眠症	過眠
慢性間質性腎炎	慢性尿細管間質性腎炎	慢性腎盂腎炎
脳溢血	脳卒中	脳出血
右下肢深部静脈血栓症	下肢静脈血栓症	上肢静脈血栓症
背部筋緊張高い	筋強直	先天性筋緊張低下
全身紅斑	紅斑症	新生児紅斑
右側下顎骨体部骨折	下顎骨骨折	上下顎骨骨折
糸球体血尿	血尿	糸球体性血尿
パニック様症状	全般性不安障害	パニック障害
爪囲紅斑	爪囲炎	丘疹状紅斑
子宮頸癌Ｉｂ１期	子宮頚癌	子宮頚管癌
感覚性運動失調	運動失調	感覚運動障害
両側鎖骨上窩リンパ節腫大	リンパ節腫大	鎖骨上リンパ節腫脹
関節滑膜炎	滑膜炎	膝関節滑膜炎
立位保持困難	四肢筋力低下	不全足位
左足痺れ	しびれ感	足背捻挫
Ｒｉｅｄｅｌ甲状腺炎	線維性甲状腺腫	急性甲状腺炎
鼻腔化膿性肉芽腫	細菌性肉芽腫症	化膿性口腔粘膜肉芽腫
右脛骨内果骨折	足関節内果骨折	脛骨遠位端骨折
左胸膜転移	胸膜播種	腹膜転移
右肺中葉転移	転移性肺癌	転移性肺腫瘍
下腿筋痛	下肢筋肉痛	大腿筋痛
右大腰筋血腫	血腫	頭部血腫
十二指腸潰瘍再発	慢性十二指腸潰瘍	再発性十二指腸潰瘍
Ａｆ不変	心室細動	Ｄ不適合
左下腿部帯状疱疹	帯状疱疹	後頭部帯状疱疹
外陰部湿疹	湿疹	頭部湿疹
両肺副雑音	胸部音異常	肺異物
左肘頭開放骨折	開放骨折	尺骨肘頭開放骨折
イレウス発生	イレウス	新生児機能性イレウス
身体損傷	損傷	頭部損傷
反応性胸水	胸水貯留	血性胸水
元々痛み	疼痛	全身痛
骨盤内膜症	骨盤子宮内膜症	骨盤腹膜炎
肝形質細胞腫	形質細胞腫	肝芽腫
躁病相	躁状態	軽躁病
ジューリング疱疹状皮膚炎	ジューリング病	小児丘疹性先端皮膚炎
副腎偶発腫	良性副腎皮質腫瘍	副腎神経芽腫
腸管通過障害	消化管狭窄	腸管運動障害
努力様呼吸	起坐呼吸	努力性呼吸
赤痢アメーバ大腸炎	アメーバ赤痢	アメーバ性非赤痢性大腸炎
Ｇｒａｄｅ　３肝障害	肝障害	Ｅ型肝炎
低ＡＬＢ血症	低アルブミン血症	高ＨＤＬ血症
肝膿瘍破裂	肝膿瘍	肝周囲膿瘍
左橈骨頭脱臼骨折	脱臼骨折	中足骨脱臼骨折
正中創感染	創傷感染症	刺創感染
左網膜分枝動脈閉塞症	動脈閉塞症	網膜動脈分枝閉塞症
常時痛み	疼痛	全身痛
多発肝転移増大	転移性肝癌	転移性肝腫瘍
左鼠径部疼痛	鼡径部痛	陰茎部疼痛
円盤状皮疹	円板状エリテマトーデス	斑状丘疹性皮疹
左手首疼痛	手部痛	中足部痛
膵体部小嚢胞	腫瘍性膵のう胞	膵のう胞
耳介脂漏性湿疹少	脂漏性皮膚炎	耳介周囲湿疹
両側急性硬膜下出血	急性硬膜下血腫	脊髄硬膜下出血
喉頭蓋腫脹	喉頭蓋炎	喉頭蓋腫瘍
肺気胸	気胸	肺気腫
深部感覚鈍麻	感覚異常症	片側感覚鈍麻
脊柱圧痛	圧痛	胸壁痛
嘔吐持続	嘔吐症	習慣性嘔吐
痙攣重積後脳症	痙攣重積型二相性急性脳症	痙攣重積型急性脳症
小腸大腸型	小腸大腸クローン病	小腸狭窄
転移性膵体部癌	膵体部癌	膵臓癌骨転移
インフルエンザＡ型感染症	インフルエンザＡ型	インフルエンザ菌ｂ型感染症
顕微鏡的大腸炎	大腸炎	急性激症型潰瘍性大腸炎
苔癬局面	苔癬	単純苔癬
足趾爪混濁肥厚	ころもじらみ寄生症	爪甲肥厚
痰貯留	喀痰	膿性痰
足趾蜂窩織炎	足蜂巣炎	蜂窩織炎
僧帽弁狭窄兼逆流症	僧帽弁狭窄症	僧帽弁逆流症
歯槽膿漏	歯周炎	歯槽膿瘍
左肘関節破壊	関節リウマチ・肘関節	人工肘関節の破損
皮下石灰化	皮膚石灰沈着症	乳房微細石灰化
軽度ＡＤＨＤ	注意欠陥多動障害	ＡＤＨ異常
両心房拡大	心肥大	巨大左心房
上転障害	眼球運動障害	過外転症候群
嫌悪感	悪寒	悪心
二次性僧帽弁閉鎖不全症	僧帽弁閉鎖不全症	先天性僧帽弁閉鎖不全症
急性大動脈弁閉鎖不全	大動脈弁閉鎖不全症	先天性大動脈弁閉鎖不全症
腹痛嘔気	嘔気	腹痛症
左大腿部骨外性粘液型軟骨肉腫	軟骨肉腫	大腿骨軟骨肉腫
高度異形成相当	子宮頚部高度異形成	外陰上皮異形成・異型度２
腹緊なし	腹部膨満	胸部よう
哺乳後嘔吐	嘔吐症	妊娠後期嘔吐
右中大脳動脈梗塞	内頚動脈塞栓症	脳外主幹動脈閉塞脳梗塞
脾臓結核	結核	肝結核
食後高血糖	高血糖症	低血糖
高浸透圧血症	高血糖高浸透圧症候群	低浸透圧血症
陰嚢ヘルニア	陰のうヘルニア	陰部ヘルニア
多形紅斑型薬疹	薬疹	紅皮症型薬疹
静脈内腫瘍栓	腫瘍	頚静脈小体腫瘍
進行再発大腸癌	大腸癌	遺伝性大腸癌
胃接合部癌	胃癌	食道胃接合部癌
手足しびれ	しびれ感	四肢しびれ
内膜損傷	損傷	後腹膜損傷
咽頭知覚障害	咽頭異常感症	咽喉頭知覚麻痺
急性胆嚢胆管炎	胆管炎	急性胆管炎
扁平上皮癌	癌	卵巣扁平上皮癌
内痔核脱出	内痔核	脱出性内痔核
Ａ型溶連菌感染症	溶連菌感染症	Ｂ群溶連菌感染症
悪性副腎外褐色細胞腫	褐色細胞腫	腎明細胞肉腫
傍隔壁型肺気腫	肺気腫	汎小葉性肺気腫
骨盤内播種新生	骨盤転移	肘部基底細胞癌
急性非代償性心不全	心不全	急性心不全
１型高ウイルスＣ型慢性肝炎	Ｃ型慢性肝炎	急性ウイルス性肝炎
Ｌｉｓｔｅｒｉａ腸炎	細菌性腸炎	エルシニア腸炎
右膿胸	膿胸	全膿胸
ヒリヒリ感	疼痛	チクチク感
大動脈弁下心室中隔欠損	心室中隔欠損症	筋性部心室中隔欠損
右傍矢状静脈洞髄膜腫	髄膜腫	傍矢状洞髄膜腫
無自覚性低血糖	低血糖	小児特発性低血糖症
心尖部型肥大型心筋症	肥大型心筋症	心尖部肥大型心筋症
びまん性大細胞	びまん性大細胞型Ｂ細胞性リンパ腫	びまん性星細胞腫
大うつ病	単極性うつ病	うつ病
肝門部悪性リンパ腫	肝門部リンパ節転移	肝脾Ｔ細胞リンパ腫
精神病性うつ病	うつ病	反復性精神病性うつ病
水疱性類天疱	水疱症	水疱性類天疱瘡
中枢性低換気	換気量減少	混合性換気障害
右膝ＡＣＬ損傷	前十字靱帯損傷	前後十字靱帯損傷
混合難聴	難聴	混合性難聴
毛孔一致性丘疹	丘疹	毛孔角化症
先天性巨大色素性母斑	巨大母斑細胞母斑	色素性母斑
左聴器癌	癌	声門癌
上腹部リンパ節転移	リンパ節転移	腹腔リンパ節転移
被殻梗塞	被殻出血	小脳梗塞
直腸Ｒａｂ癌	直腸癌	直腸癌穿孔
軽度高血糖	高血糖症	低血糖
本日硬便少量	便異常	大量便
２型腫瘤	腫瘤	精索腫瘤
リンパ節圧痛	圧痛	緊張型頭痛
小血栓	血液凝固異常	血栓性微小血管症
急性期ＨＩＶ感染症	ＨＩＶ感染症	急性ＨＩＶ感染症候群
上行結腸腫瘤	腫瘤	横行結腸腫瘍
疾病不安	不安障害	疾病恐怖症
膿貯留	膿瘍	膿疱
片側副腎腫瘍	副腎腫瘍	非機能性副腎腫瘍
リンパ節腫脹	リンパ節腫大	縦隔リンパ節腫脹
右椎骨動脈巨大血栓化動脈瘤	椎骨動脈瘤	椎骨動脈血栓症
カテ感染	カテーテル感染症	先天性感染
安心感	心気症	倦怠感
左鼡径ヘルニア再発	鼡径ヘルニア	再発性鼡径ヘルニア
胃食道静脈瘤破裂	食道静脈瘤破裂	胃静脈瘤破裂
左足背蜂窩織炎	足背蜂巣炎	蜂窩織炎
暗青色斑	青色母斑	黄色斑眼底
過敏性膀胱炎	膀胱炎	急性膀胱炎
進行肺癌	肺癌	中葉肺癌
外傷性変化	外傷	多発性外傷
中等度精神遅滞	中等度知的障害	非定型精神障害
リポフスチン沈着	神経セロイドリポフスチン症	ヘモジデリン沈着症
胸部圧痛	圧痛	腹部圧痛
気分不快症状	悪心	気分変調症
褥創形成	褥瘡	腟開放創
ガマ腫	がま腫	ゴム腫
夜間せん妄状態	せん妄	夜間せん妄
神経系腫瘍	腫瘍	神経細胞腫瘍
先天性側弯	肋骨異常を伴う先天性側弯症	変性側弯症
非定型抗酸菌肺炎	肺炎	好酸球性肺炎
軽度甲状腺腫大	甲状腺腫	単純性甲状腺腫
手足痺れ	四肢しびれ	手足症候群
節外性濾胞辺縁帯リンパ腫	脾辺縁帯リンパ腫	濾胞性リンパ腫
若年性認知症	認知症	老年期認知症
外腸骨域リンパ節腫大	リンパ節腫大	腸間膜リンパ節腫脹
鼠径ヘルニア	鼡径ヘルニア	壊疽性臍ヘルニア
分化型管状腺癌	癌	甲状腺未分化癌
右下葉結節影	胸部異常陰影	下肺野陰影
軽度左軸偏位	心電図左軸偏位	尺側偏位
食道がん	食道癌	食道びらん
肛門部発赤	発赤	咽頭発赤
下腿潰瘍	下腿皮膚潰瘍	下腿難治性皮膚潰瘍
非浸潤性尿路上皮癌	尿管尿路上皮癌	膀胱尿路上皮癌
下咽頭がん	下咽頭癌	咽頭のう
両上肢痺れ	上肢しびれ	痙性四肢麻痺
混合性肝癌	肝癌	混合型肝癌
甲状腺痛	甲状腺炎	前立腺痛
不消化便	消化不良性下痢	大量便
末梢性めまい	めまい症	末梢性めまい症
四肢型運動失調	運動失調	四肢運動障害
産生胃癌	胃癌	早期胃癌
左脛腓骨骨折	腓骨骨折	脛骨腓骨骨折
先天性脳血管異常	脳動静脈奇形	脳血管障害
臀部皮疹	発疹	腋窩湿疹
心室中隔扁平化	心室中隔欠損症	心室中隔瘤
フルニエ壊疽	外陰部壊死性筋膜炎	壊疽
歯牙損傷	切歯破折	歯肉外傷
両側乳糜胸水	胸水貯留	胎児胸水
麻疹罹患歴	麻疹	非定型麻疹
尿漏れ	尿失禁症	尿道漏
心膜播種	腹膜播種	胸膜播種
髄液播種	腹膜播種	髄液混濁
後頭部皮下血腫	頭部皮下血腫	側頭部皮下血腫
ＭＲＳＡ菌血症	ＭＲＳＡ感染症	真菌血症
篩骨蜂巣	篩骨洞炎	篩骨洞のう胞
仮性動脈瘤切除	偽性動脈瘤	動脈瘤
鼻中隔血腫	血腫	耳介皮下血腫
左嗅裂ポリープ	ポリープ	中耳ポリープ
軽度失調性構音障害	構音障害	器質性構音障害
びらんからの出血	出血	第３期出血
動揺性精神神経症状	神経症	動脈硬化性精神障害
過呼吸気味	過換気症	多呼吸
真菌性感染性心内膜炎	細菌性心内膜炎	亜急性感染性心内膜炎
未分類関節炎	関節炎	単関節炎
骨突出部発赤	発赤	下腿発赤
神経症性うつ病	抑うつ神経症	思春期うつ病
右浸潤影	胸部異常陰影	下肺野陰影
四肢近位筋筋力低下	筋力低下	四肢筋力低下
右乳腺良性腫瘍	乳腺腫瘍	乳腺悪性腫瘍
イレウス気味	偽性イレウス	イレウス
再度皮疹	発疹	四肢発疹
低形成	骨髄低形成	舌低形成
血管原性浮腫	浮腫	遺伝性血管性浮腫
Ｂｌｕｅ　ｔｏｅ　ｓｙｎｄｒｏｍｅ	末梢動脈疾患	ＭＮＧＩＥ
嚢胞様腫瘤像	腫瘤	皮下腫瘤
婦人科癌	癌	精巣胎児性癌
両側眼振	眼振	眼性眼振
爪水虫	爪白癬	水胸
ＢＰＳＤ	認知症に重なったせん妄	ＨＤＬＳ
汎発性水痘感染症	水痘	先天性水痘症候群
えん下障害	嚥下障害	陰のうびらん
左側頭葉挫傷	脳挫傷	前頭部挫傷
虚血性肝炎	肝炎	慢性肝炎
圧迫移植部ネクローシス	壊死	ＩＵＤ挿入
舌乾燥	口腔乾燥症	口唇乾燥
円形紅斑	紅斑症	多形紅斑
左眼後発性白内障	白内障	先天性白内障
膵尾部腫瘤性病変	膵腫瘤	膵頭部腫瘤
重症腸炎	腸炎	小腸炎
左大腿骨転子下骨折	転子下骨折	大腿骨転子部骨折
肺野すりガラス状陰影	肺野異常陰影	肺野円形陰影
アテローム性血栓性脳梗塞	血栓性脳梗塞	アテローム血栓性脳梗塞
結腸癌肝転移	転移性肝癌	肝癌骨転移
診察時皮疹	発疹	四肢発疹
切開関連性心房粗動	心房粗動	一過性心房粗動
硬性白斑	白斑	老人性白斑
術後不整脈	不整脈	術中不整脈
起床時咳嗽	咳	慢性咳嗽
血性腹水貯留	腹水症	血性腹水
心理的不安	不安障害	器質性不安障害
右小細胞癌	小細胞肺癌	卵巣小細胞癌
多源性ＰＶＣ散発	心室期外収縮	多源性心室期外収縮
原発性甲状腺機能低下	甲状腺機能低下症	原発性甲状腺機能低下症
ヨードアレルギー	ヨード過敏症	アレルギー
活動性肝炎	肝炎	活動性慢性肝炎
排便なし	便秘症	排便障害
全身性Ｃａｎｄｉｄａ感染症	カンジダ症	ＭＲＣＮＳ感染症
顔面神経痛	三叉神経痛	側頭部神経痛
アルコ−ル性肝硬変	肝硬変症	アルコール性肝硬変
皮質層状壊死	壊死	中毒性表皮壊死症
発熱随伴症状	発熱	新生児発熱
脳炎脳症	脳症	脳炎
辺縁性脳炎	脳炎	辺縁系脳炎
圧迫時疼痛	疼痛	難治性疼痛
症型Ａ群溶連菌感染症	溶連菌感染症	Ｂ群溶連菌感染症
末梢肺動脈塞栓症	動脈塞栓症	末梢性肺動脈狭窄症
歩容困難	歩行障害	歩行困難
脳室出血	出血	脳室内出血
顔面痺れ	しびれ感	顔面ざ瘡
重度失調性構音障害	構音障害	器質性構音障害
卵巣癌Ⅲｃ期	卵巣癌	卵巣胎児性癌
低血糖鞘状	低血糖	夜間低血糖症
発赤潰瘍	発赤	皮膚潰瘍
左下肺浸潤影	肺部異常陰影	下肺野陰影
右大脳動脈未破裂動脈瘤	脳動脈瘤	未破裂脳動脈瘤
ｃｅｌｌ　ｌｅｕｋｅｍｉａ	白血病	ＣＡＤＡＳＩＬ
大動脈弁硬化症	大動脈弁狭窄症	大動脈弁閉鎖症
ＡＣＴＨ非依存性Ｃｕｓｈｉｎｇ症候群	クッシング症候群	副腎皮質刺激ホルモン不応症
熱	発熱	熱射病
Ｍａｌｌｏｒｙ−Ｗｅｉｓｓ症候群	マロリ・ワイス症候群	ＭＥＬＡＳ症候群
ドレーン出血	出血	後出血
副鼻腔転移	副鼻腔癌	腹膜転移
原発不明癌頸部転移	原発不明癌	多発性癌転移
再発腫瘤	腫瘤	多発性皮下腫瘤
犬吠様咳嗽	咳	遷延性咳嗽
左室ブロック波形	心電図異常	房室ブロック
有痛性腫瘤	腫瘤	頭部腫瘤
起床時頭痛	頭痛	発作性頭痛
Ⅱ型房室ブロック	房室ブロック	高度房室ブロック
眼白内障	白内障	層間白内障
慢性下気道感染	急性気管支炎	上気道閉塞症
乳頭様腎盂腫瘍	腎盂乳頭状癌	腎盂腫瘍
両側下腿潰瘍	下腿皮膚潰瘍	下腿難治性皮膚潰瘍
心肺停止後蘇生	心肺停止	来院時心肺停止
無症候性腸アメーバ症	腸アメーバ症	慢性腸アメーバ症
命令性幻聴	幻聴	器質性幻覚症
両側副腎腫瘍	副腎腫瘍	非機能性副腎腫瘍
左顔面神経麻痺症状	顔面神経麻痺	末梢性顔面神経麻痺
左顔面痛覚障害	片側痛覚鈍麻	片側痛覚消失
粘膿性鼻汁	鼻汁	膿性鼻閉
膣原発横紋筋肉腫	横紋筋肉腫	鼡径部横紋筋肉腫
卵巣嚢腫ＯＰ	卵巣のう腫	卵巣門細胞腫
肺血管陰影増強	肺血管疾患	肺門部異常陰影
Ｈｏｄｇｋｉｎ　Ｌｙｍｐｈｏｍａ	ホジキンリンパ腫	ＭＮＧＩＥ
術後創感染	術後膿瘍	術後創部感染
右下葉扁平上皮癌	下葉肺扁平上皮癌	上葉肺扁平上皮癌
咳嗽法	咳	慢性咳嗽
高リスク前立腺癌	前立腺癌	進行性前立腺癌
認知面低下	軽度認知障害	下肢知覚低下
膿梗塞	脳梗塞	全膿胸
火傷	熱傷	肺損傷
入眠困難感	不眠症	倦怠感
非定型カルチノイド腫瘍	カルチノイド	異所性ホルモン産生腫瘍
軽度食欲低下	食欲不振	神経性食欲異常
両下腿壊疽性膿皮症様潰瘍	膿皮症	潰瘍性慢性膿皮症
恥骨骨髄炎	骨髄炎	恥骨骨炎
かすみ目	視力低下	しらみ症
眩暈消失	めまい	起立性眩暈
手指関節腫脹	関節炎	足関節腫脹
ＳＰＮ	充実性偽乳頭状腫瘍	ＰＣＷＨ
慢性的な呼吸困難	呼吸困難	夜間呼吸困難
右肺下葉肺炎	肺炎	大葉性肺炎
低酸素虚血性脳症	低酸素性脳症	新生児低酸素性虚血性脳症
膵臓癌術後再発	膵癌	膵頚部癌
歩行ふらつき	めまい	よろめき歩行
結腸縫合不全	縫合不全	腹壁縫合不全
紅色腫瘤	腫瘤	顔面腫瘤
神経アミロイドーシス	アミロイドーシス	神経サルコイドーシス
咽頭粘膜発赤	発赤	咽頭発赤
新生児死亡	原因不明の死亡	新生児仮死
右肺下葉癌	下葉肺癌	上葉肺癌
腎結石多発	腎結石症	多発性腎結石
外表奇形	奇形	下肢奇形
Ｉｓｐポリープ	大腸ポリープ	ポリープ
咽頭部発赤	発赤	咽頭発赤
頭部腫瘍	頭部皮下腫瘍	側頭葉腫瘍
遅発性発疹	発疹	特発性発疹
骨外腫瘤形成	腫瘤	骨盤内腫瘤
低悪性度Ｂ細胞性リンパ腫	びまん性大細胞型Ｂ細胞性リンパ腫	ＡＬＫ陽性大細胞型Ｂ細胞性リンパ腫
単形性ＶＴ	非持続性心室頻拍	換気量減少
特発性心室細動	心室細動	一過性心室細動
白色調腫瘍	腫瘍	頭皮良性腫瘍
Ｇｏｔｔｒｏｎ徴候	ゴットロン丘疹	ＮＬＲＣ４異常症
脊柱起立筋膿瘍	筋膿瘍	低位筋間膿瘍
胃癌幽門狭窄	幽門狭窄症	胃幽門部癌
拡張能障害	心不全	頭囲拡大
小腸静脈瘤破裂	食道静脈瘤破裂	胃静脈瘤破裂
中枢性甲状腺機能低下症	甲状腺機能低下症	二次性甲状腺機能低下症
左肺動脈閉塞	肺動脈狭窄症	純型肺動脈閉鎖
単純性網膜症	網膜症	中心性網膜症
Ｈｅｎｏｃｈ−Ｓｃｈｏｎｌｅｉｎ紫斑病	ＩｇＡ血管炎	クリオグロブリン血症性紫斑病
右胸腔内腫瘍	腫瘍	胸膜腫瘍
尿もれ	尿失禁症	残尿感
下肢筋力低下自覚	筋力低下	四肢筋力低下
右足静脈瘤	静脈瘤	下肢静脈瘤
上気道浮腫	咽頭浮腫	上肢浮腫
吻合部浮腫	浮腫	陰茎浮腫
Ｃａｐｎｏｃｙｔｏｐｈａｇａ　ｃａｎｉｍｏｒｓｕｓ感染症	グラム陰性菌感染症	ＭＲＣＮＳ感染症
呼吸喘鳴	喘鳴	呼吸促迫
口腔内乾燥	口腔乾燥症	口内乾燥
ヘルペス髄膜炎	髄膜炎	ヘルペスウイルス髄膜炎
左股関節破壊	股関節症	股関節損傷
膠原繊維性腸炎	腸炎	偽膜性腸炎
食道期軽度障害	嚥下障害	食道障害
右外腸骨静脈狭窄	静脈狭窄	外腸骨動脈狭窄
呼内疾患ベース肺炎	肺炎	細菌性肺炎
白色粘性痰	喀痰	膿性痰
ｌｙｍｐｈｏｍａ	悪性リンパ腫	ＡＶＭ
左足首骨折	足関節骨折	足背骨折
逆流性食道炎症状	逆流性食道炎	難治性逆流性食道炎
抑うつあり	うつ状態	抑うつ神経症
急性感音性難聴	感音難聴	両側性感音難聴
リンパ節多発転移	多部位リンパ節転移	リンパ節転移
ｉｎｖａｓｉｖｅ　ｔｈｙｍｏｍａ	悪性胸腺腫	ＡＶＭ
分類不能型免疫不全	免疫不全	分類不能免疫不全症
非典型的胸痛	胸痛	反復性胸痛
Ｓ状結腸癌術後肝転移	転移性肝癌	肝癌骨転移
棘波	心電図異常	棘刺創
黄色痰自己喀出	膿性痰	喀痰喀出困難
心膜腔内播種	転移性心腫瘍	胸膜播種
四肢末端しびれ	しびれ感	四肢端しびれ
胃部分壊死	壊死	腸壊死
転倒受傷	外傷	自傷
左急性感音難聴	感音難聴	両側性感音難聴
タール便少量	黒色便	大量便
切除不能胃癌	胃癌	早期胃癌
後頭葉脳出血	脳出血	脳幹部出血
隅角結節	虹彩結節	隅角癒着
落ち着かなさ	多動性障害	倦怠感
脊椎多発圧迫骨折	圧迫骨折	脊椎圧迫骨折
左傍脊柱筋膿瘍	筋膿瘍	低位筋間膿瘍
Ⅰ型ＤＭ	糖尿病	２型糖尿病
大腸粘膜癌	癌	大腸粘液癌
大動脈損傷	上大動脈損傷	動脈損傷
仙骨前腫瘤	腫瘤	骨盤内腫瘤
前頭葉脳出血	脳出血	脳幹部出血
社会不安症	不安神経症	社会不安障害
左頚部食道傍リンパ節転移	リンパ節転移	胃周囲リンパ節転移
時折物忘れ	健忘症	弄舌癖
左頬部未分化腺癌	癌	甲状腺未分化癌
ＩＩ型ＤＭ	２型糖尿病	筋強直性ジストロフィー
膨満　グル音正常	腹部膨満	腸音亢進
低分化性扁平上皮癌	癌	中葉肺扁平上皮癌
左房内粘液腫	心臓粘液腫	腹膜偽粘液腫
重症うつ病	うつ病	内因性うつ病
左肺下葉浸潤影	胸部異常陰影	下肺野陰影
中葉舌区症候群	中葉無気肺	小舌症
軟部組織腫瘤	腫瘤	項部腫瘤
慢性誤嚥	嚥下障害	異物誤嚥
Ｇｍ敗血症	敗血症	ＧＢＳ敗血症
右大腿部蜂窩織炎	大腿部蜂巣炎	蜂窩織炎
病的腹水	腹水症	異常腹水
慢性疲労	疲労感	慢性疲労症候群
Ｃｈｏｌｅｄｏｃｈｏｃｅｌｅ	総胆管のう腫	ＣＨＩＬＤ症候群
肺門腫瘤	縦隔腫瘍	肺腫瘤
右鎖骨転移	骨転移癌	肋骨転移
夕方痛み	疼痛	上肢痛
左側副部痛	側腹部痛	側頭部痛
後腹膜腫瘍上行結腸浸潤	後腹膜腫瘍	下行結腸粘膜下腫瘍
左臀部悪性軟部腫瘍	殿部悪性軟部腫瘍	腹部悪性軟部腫瘍
発熱コントロール	発熱	突発性発熱
右下腿蜂窩織炎	下腿蜂巣炎	蜂窩織炎
ブドウ球菌検出	ぶどう球菌感染症	グラム陽性球菌感染症
Ｅｓｃｈｅｒｉｃｈｉａ　ｃｏｌｉ	大腸菌感染症	大腸菌食中毒
両側網膜剥離	網膜剥離	先天性網膜剥離
右房浸潤	乳房悪性腫瘍	髄膜浸潤
屈筋腱鞘炎	腱鞘炎	手屈筋腱腱鞘炎
肺結節陰影	胸部異常陰影	下肺野陰影
呼吸困難感等自覚症状	呼吸困難	呼吸困難発作
右鎖骨上窩リンパ節腫大	鎖骨上リンパ節腫脹	リンパ節腫大
低悪性度リンパ腫	ホジキンリンパ腫	悪性リンパ腫
陰部腫脹	陰のう腫大	殿部腫脹
腹水浸出	腹水症	滲出性腹水
腸管皮膚瘻	腸瘻	直腸皮膚瘻
ライン感染	カテーテル感染症	ドライブライン感染
多発擦過傷	擦過創	多発性擦過創
Ｃｈｕｒｇ−Ｓｔｒａｕｓｓ　症候群	好酸球性多発血管炎性肉芽腫症	ＣＨＡＲＧＥ症候群
脾結核	結核	肝結核
潰瘍性大腸炎急性増悪	潰瘍性大腸炎	急性潰瘍性大腸炎
肺抗酸菌感染症	肺非結核性抗酸菌症	肺炎球菌感染症
両眼網膜症	網膜症	近視性網膜症
左眼結膜炎	結膜炎	眼瞼結膜炎
右肺原発腺癌	肺腺癌	上葉肺腺癌
感覚神経障害	知覚障害	感覚異常症
物忘れ	健忘症	妄想反応
脳筋症	ミトコンドリア脳筋症	急性脳症
駆細胞型急性リンパ性白血病再発	急性リンパ性白血病	Ｔ細胞性前リンパ球白血病
僧房弁疣贅	疣贅	尋常性疣贅
腹部背部痛	背部痛	側腹部痛
慢性突発性血小板減少性紫斑病	血小板減少性紫斑病	慢性特発性血小板減少性紫斑病
下部消化管穿孔	腸穿孔	根管側壁穿孔
Ｔ字杖歩行可能	歩行障害	歩行困難
鎖骨上リンパ節腫大	鎖骨上リンパ節腫脹	リンパ節腫大
大腫瘤影	腫瘤	項部腫瘤
ヘルペス性脳炎	サル痘	ヘルペス脳炎
不安症様	不安神経症	不安障害
下肢骨折	骨折	上肢骨折
アスピリンアレルギー	アスピリン不耐症	ペニシリンアレルギー
固形腫瘍	腫瘍	葉状腫瘍
嘔吐出現	嘔吐症	新生児嘔吐
統合失調症残遺状態	統合失調症	残遺型統合失調症
右上肢不全片麻痺	不全片麻痺	上肢不全麻痺
頭位性回転性めま	体位性めまい	回転性めまい
口唇紅潮	紅潮	顔面紅潮
開腹腫瘤	腫瘤	腹部腫瘤
外側部乳癌	乳癌	乳房下外側部乳癌
胃のむかつき	悪心	胃瘻
痒疹結節散在	痒疹	結節性痒疹
日中下痢	下痢症	食事性下痢
先天性胆管欠損	胆管先天奇形	先天性胆管拡張症
冠性Ｔ波	心電図異常	軟部腫瘍
多発胸膜肥厚斑	胸膜肥厚	良性胸膜中皮腫
カンジダ眼内炎	眼内炎	カンジダ性口内炎
仙骨部腫瘤	腫瘤	頚部腫瘤
喘息症状	咳喘息	外因性喘息
ふらつく気	よろめき歩行	気うつ
拡張障害型心不全	心不全	新生児心不全
アカシジア症状	錐体路障害	先天性アカラシア
間歇的腹痛	腹痛症	反復性腹痛
星状細胞腫	星細胞腫	星状芽細胞腫
陳旧性脳出血	脳出血	新生児脳出血
良性下垂体腫瘍	下垂体腫瘍	悪性下垂体腫瘍
左側頭部帯状疱疹	帯状疱疹	後頭部帯状疱疹
頭蓋内出血性病変	非外傷性頭蓋内出血	新生児頭蓋内出血
右披裂部腫瘍	腫瘍	鎖骨部腫瘍
両膝変形	変形性膝関節症	足部変形
表在性腫瘍	腫瘍	良性腫瘍
左母指多指症	副母趾	母指三指節症
アルコール性末梢神経障害	アルコール性多発ニューロパチー	アルコール性神経筋障害
暗紅色斑	紅斑症	黄色斑眼底
気管支喘息発症	気管支喘息	気管支喘息発作
分葉状嚢胞性腫瘤	腫瘤	多発性皮下腫瘤
甲状腺肥大	甲状腺疾患	胸腺肥大
患肢発赤	発赤	下腿発赤
好中球浸潤	好中球増加症	髄液好中球数増加
多房性腫瘤	腫瘤	精索腫瘤
左内耳障害	迷路障害	小耳症
左耳介発赤	発赤	下腿発赤
副腎性クッシング症侯群	クッシング症候群	副腎性器症候群
痛く	疼痛	全身痛
皮疹再燃	発疹	四肢発疹
子宮筋腫手術	子宮筋腫	子宮筋腫術後
腕頭静脈血栓症	静脈血栓症	上腕静脈血栓症
脊椎病変	脊椎異常	脊椎疾患
歯状核	歯状核赤核淡蒼球ルイ体萎縮症	殻状歯
ＥＢＶ腸炎	細菌性腸炎	ＭＲＳＡ腸炎
左側舌癌	舌癌	舌下面癌
足しびれ	下肢しびれ	四肢しびれ
膵内分泌腫瘍肝転移	転移性肝癌	転移性膵腫瘍